Democrats,Republicans,Others,Total,ED,RD,year,month,county
733,700,618,2051,05,11,2018,January,Kent
629,736,615,1980,06,11,2018,January,Kent
783,610,538,1931,07,11,2018,January,Kent
331,297,320,948,08,11,2018,January,Kent
261,463,296,1020,09,11,2018,January,Kent
290,387,308,985,10,11,2018,January,Kent
842,415,510,1767,01,28,2018,January,Kent
752,302,358,1412,02,28,2018,January,Kent
754,539,520,1813,03,28,2018,January,Kent
1219,454,603,2276,04,28,2018,January,Kent
561,323,346,1230,05,28,2018,January,Kent
899,220,394,1513,06,28,2018,January,Kent
738,459,400,1597,07,28,2018,January,Kent
195,218,158,571,08,28,2018,January,Kent
680,217,284,1181,09,28,2018,January,Kent
761,196,282,1239,10,28,2018,January,Kent
203,186,129,518,11,28,2018,January,Kent
98,68,73,239,12,28,2018,January,Kent
258,104,93,455,13,28,2018,January,Kent
421,189,179,789,14,28,2018,January,Kent
1699,744,733,3176,01,29,2018,January,Kent
108,110,91,309,02,29,2018,January,Kent
1097,636,575,2308,03,29,2018,January,Kent
653,436,366,1455,04,29,2018,January,Kent
482,320,329,1131,05,29,2018,January,Kent
1280,534,552,2366,06,29,2018,January,Kent
512,356,297,1165,07,29,2018,January,Kent
796,811,646,2253,08,29,2018,January,Kent
565,764,449,1778,09,29,2018,January,Kent
69,150,110,329,10,29,2018,January,Kent
138,167,120,425,11,29,2018,January,Kent
120,53,63,236,12,29,2018,January,Kent
149,154,114,417,13,29,2018,January,Kent
348,442,370,1160,01,30,2018,January,Kent
181,164,149,494,02,30,2018,January,Kent
632,577,529,1738,03,30,2018,January,Kent
715,645,508,1868,04,30,2018,January,Kent
450,721,549,1720,05,30,2018,January,Kent
201,274,194,669,06,30,2018,January,Kent
152,265,169,586,07,30,2018,January,Kent
873,587,602,2062,08,30,2018,January,Kent
651,586,500,1737,09,30,2018,January,Kent
354,352,286,992,10,30,2018,January,Kent
337,472,264,1073,11,30,2018,January,Kent
288,529,336,1153,12,30,2018,January,Kent
321,101,143,565,01,31,2018,January,Kent
671,545,447,1663,02,31,2018,January,Kent
1000,356,351,1707,03,31,2018,January,Kent
758,363,403,1524,04,31,2018,January,Kent
914,460,440,1814,05,31,2018,January,Kent
1319,300,494,2113,06,31,2018,January,Kent
1008,291,376,1675,07,31,2018,January,Kent
602,166,276,1044,08,31,2018,January,Kent
451,290,279,1020,09,31,2018,January,Kent
452,205,255,912,10,31,2018,January,Kent
485,314,253,1052,11,31,2018,January,Kent
23,11,12,46,16,31,2018,January,Kent
985,310,454,1749,01,32,2018,January,Kent
629,252,290,1171,02,32,2018,January,Kent
764,372,357,1493,03,32,2018,January,Kent
32,15,13,60,04,32,2018,January,Kent
798,455,479,1732,05,32,2018,January,Kent
136,129,104,369,06,32,2018,January,Kent
1174,441,546,2161,07,32,2018,January,Kent
320,52,124,496,08,32,2018,January,Kent
567,338,429,1334,09,32,2018,January,Kent
391,146,191,728,10,32,2018,January,Kent
675,349,400,1424,11,32,2018,January,Kent
486,424,339,1249,12,32,2018,January,Kent
262,202,149,613,01,33,2018,January,Kent
564,509,441,1514,02,33,2018,January,Kent
766,790,603,2159,03,33,2018,January,Kent
640,867,636,2143,04,33,2018,January,Kent
766,612,605,1983,05,33,2018,January,Kent
92,108,80,280,06,33,2018,January,Kent
395,545,369,1309,07,33,2018,January,Kent
769,850,603,2222,08,33,2018,January,Kent
1174,739,641,2554,09,33,2018,January,Kent
497,615,412,1524,10,33,2018,January,Kent
814,585,595,1994,01,34,2018,January,Kent
373,347,301,1021,02,34,2018,January,Kent
1101,671,632,2404,03,34,2018,January,Kent
273,280,262,815,04,34,2018,January,Kent
896,803,638,2337,05,34,2018,January,Kent
368,282,239,889,06,34,2018,January,Kent
371,519,325,1215,07,34,2018,January,Kent
780,831,580,2191,08,34,2018,January,Kent
992,682,533,2207,09,34,2018,January,Kent
1091,924,707,2722,10,34,2018,January,Kent
21,29,30,80,11,34,2018,January,Kent
735,707,625,2067,05,11,2018,February,Kent
625,738,612,1975,06,11,2018,February,Kent
785,612,542,1939,07,11,2018,February,Kent
331,295,323,949,08,11,2018,February,Kent
261,465,298,1024,09,11,2018,February,Kent
290,387,309,986,10,11,2018,February,Kent
841,416,510,1767,01,28,2018,February,Kent
754,299,359,1412,02,28,2018,February,Kent
755,538,521,1814,03,28,2018,February,Kent
1226,455,605,2286,04,28,2018,February,Kent
564,324,349,1237,05,28,2018,February,Kent
902,219,395,1516,06,28,2018,February,Kent
736,453,398,1587,07,28,2018,February,Kent
196,217,158,571,08,28,2018,February,Kent
681,218,286,1185,09,28,2018,February,Kent
756,195,281,1232,10,28,2018,February,Kent
205,186,129,520,11,28,2018,February,Kent
98,68,73,239,12,28,2018,February,Kent
258,103,93,454,13,28,2018,February,Kent
424,192,180,796,14,28,2018,February,Kent
1700,744,737,3181,01,29,2018,February,Kent
107,112,93,312,02,29,2018,February,Kent
1098,639,573,2310,03,29,2018,February,Kent
660,441,370,1471,04,29,2018,February,Kent
482,322,329,1133,05,29,2018,February,Kent
1285,532,556,2373,06,29,2018,February,Kent
512,358,295,1165,07,29,2018,February,Kent
797,809,651,2257,08,29,2018,February,Kent
563,767,450,1780,09,29,2018,February,Kent
71,152,110,333,10,29,2018,February,Kent
140,168,118,426,11,29,2018,February,Kent
121,53,63,237,12,29,2018,February,Kent
151,154,114,419,13,29,2018,February,Kent
345,441,370,1156,01,30,2018,February,Kent
183,164,146,493,02,30,2018,February,Kent
634,581,528,1743,03,30,2018,February,Kent
713,647,514,1874,04,30,2018,February,Kent
451,722,547,1720,05,30,2018,February,Kent
200,275,197,672,06,30,2018,February,Kent
152,263,172,587,07,30,2018,February,Kent
880,592,602,2074,08,30,2018,February,Kent
644,587,498,1729,09,30,2018,February,Kent
357,353,289,999,10,30,2018,February,Kent
335,472,265,1072,11,30,2018,February,Kent
294,532,334,1160,12,30,2018,February,Kent
324,102,142,568,01,31,2018,February,Kent
670,545,447,1662,02,31,2018,February,Kent
1000,357,356,1713,03,31,2018,February,Kent
757,363,402,1522,04,31,2018,February,Kent
917,459,443,1819,05,31,2018,February,Kent
1329,300,497,2126,06,31,2018,February,Kent
1014,289,384,1687,07,31,2018,February,Kent
602,164,279,1045,08,31,2018,February,Kent
452,288,277,1017,09,31,2018,February,Kent
454,204,256,914,10,31,2018,February,Kent
484,313,256,1053,11,31,2018,February,Kent
23,11,12,46,16,31,2018,February,Kent
986,310,456,1752,01,32,2018,February,Kent
631,254,290,1175,02,32,2018,February,Kent
764,374,357,1495,03,32,2018,February,Kent
32,16,13,61,04,32,2018,February,Kent
795,460,480,1735,05,32,2018,February,Kent
137,129,105,371,06,32,2018,February,Kent
1173,443,546,2162,07,32,2018,February,Kent
319,53,125,497,08,32,2018,February,Kent
572,341,431,1344,09,32,2018,February,Kent
396,146,192,734,10,32,2018,February,Kent
680,349,399,1428,11,32,2018,February,Kent
491,425,340,1256,12,32,2018,February,Kent
262,200,152,614,01,33,2018,February,Kent
564,511,439,1514,02,33,2018,February,Kent
763,791,602,2156,03,33,2018,February,Kent
647,870,635,2152,04,33,2018,February,Kent
767,613,602,1982,05,33,2018,February,Kent
94,109,78,281,06,33,2018,February,Kent
390,545,367,1302,07,33,2018,February,Kent
777,850,608,2235,08,33,2018,February,Kent
1174,736,647,2557,09,33,2018,February,Kent
500,619,413,1532,10,33,2018,February,Kent
819,591,598,2008,01,34,2018,February,Kent
377,345,303,1025,02,34,2018,February,Kent
1111,675,633,2419,03,34,2018,February,Kent
274,282,262,818,04,34,2018,February,Kent
904,804,645,2353,05,34,2018,February,Kent
365,282,239,886,06,34,2018,February,Kent
371,521,326,1218,07,34,2018,February,Kent
780,827,578,2185,08,34,2018,February,Kent
990,683,534,2207,09,34,2018,February,Kent
1095,927,713,2735,10,34,2018,February,Kent
21,28,30,79,11,34,2018,February,Kent
735,707,622,2064,05,11,2018,March,Kent
621,737,615,1973,06,11,2018,March,Kent
783,613,537,1933,07,11,2018,March,Kent
330,297,323,950,08,11,2018,March,Kent
261,460,298,1019,09,11,2018,March,Kent
290,384,309,983,10,11,2018,March,Kent
847,415,508,1770,01,28,2018,March,Kent
758,302,361,1421,02,28,2018,March,Kent
756,538,521,1815,03,28,2018,March,Kent
1223,455,609,2287,04,28,2018,March,Kent
564,321,352,1237,05,28,2018,March,Kent
895,222,394,1511,06,28,2018,March,Kent
738,454,398,1590,07,28,2018,March,Kent
194,216,159,569,08,28,2018,March,Kent
686,220,283,1189,09,28,2018,March,Kent
752,196,281,1229,10,28,2018,March,Kent
204,186,131,521,11,28,2018,March,Kent
98,69,75,242,12,28,2018,March,Kent
262,103,94,459,13,28,2018,March,Kent
432,192,177,801,14,28,2018,March,Kent
1712,748,741,3201,01,29,2018,March,Kent
108,111,92,311,02,29,2018,March,Kent
1103,642,576,2321,03,29,2018,March,Kent
667,443,376,1486,04,29,2018,March,Kent
482,322,331,1135,05,29,2018,March,Kent
1284,534,558,2376,06,29,2018,March,Kent
517,361,296,1174,07,29,2018,March,Kent
801,810,651,2262,08,29,2018,March,Kent
564,767,451,1782,09,29,2018,March,Kent
70,153,109,332,10,29,2018,March,Kent
140,166,119,425,11,29,2018,March,Kent
122,52,65,239,12,29,2018,March,Kent
149,154,112,415,13,29,2018,March,Kent
344,441,374,1159,01,30,2018,March,Kent
184,165,144,493,02,30,2018,March,Kent
639,582,530,1751,03,30,2018,March,Kent
719,646,514,1879,04,30,2018,March,Kent
449,721,548,1718,05,30,2018,March,Kent
200,275,197,672,06,30,2018,March,Kent
150,261,172,583,07,30,2018,March,Kent
889,595,606,2090,08,30,2018,March,Kent
643,591,497,1731,09,30,2018,March,Kent
358,357,287,1002,10,30,2018,March,Kent
332,474,268,1074,11,30,2018,March,Kent
296,533,334,1163,12,30,2018,March,Kent
325,103,144,572,01,31,2018,March,Kent
666,547,451,1664,02,31,2018,March,Kent
1001,359,355,1715,03,31,2018,March,Kent
761,360,404,1525,04,31,2018,March,Kent
919,463,446,1828,05,31,2018,March,Kent
1329,300,495,2124,06,31,2018,March,Kent
1020,291,379,1690,07,31,2018,March,Kent
599,165,279,1043,08,31,2018,March,Kent
454,285,273,1012,09,31,2018,March,Kent
459,201,261,921,10,31,2018,March,Kent
482,316,255,1053,11,31,2018,March,Kent
23,11,12,46,16,31,2018,March,Kent
976,306,455,1737,01,32,2018,March,Kent
636,255,291,1182,02,32,2018,March,Kent
766,369,356,1491,03,32,2018,March,Kent
32,16,13,61,04,32,2018,March,Kent
793,459,476,1728,05,32,2018,March,Kent
135,128,105,368,06,32,2018,March,Kent
1181,444,539,2164,07,32,2018,March,Kent
318,53,125,496,08,32,2018,March,Kent
570,346,433,1349,09,32,2018,March,Kent
397,147,186,730,10,32,2018,March,Kent
683,347,397,1427,11,32,2018,March,Kent
494,423,337,1254,12,32,2018,March,Kent
262,201,151,614,01,33,2018,March,Kent
566,513,435,1514,02,33,2018,March,Kent
760,789,597,2146,03,33,2018,March,Kent
646,867,639,2152,04,33,2018,March,Kent
770,617,607,1994,05,33,2018,March,Kent
95,110,78,283,06,33,2018,March,Kent
389,543,372,1304,07,33,2018,March,Kent
778,851,610,2239,08,33,2018,March,Kent
1177,741,647,2565,09,33,2018,March,Kent
496,621,415,1532,10,33,2018,March,Kent
818,591,606,2015,01,34,2018,March,Kent
376,342,304,1022,02,34,2018,March,Kent
1119,674,637,2430,03,34,2018,March,Kent
274,283,261,818,04,34,2018,March,Kent
902,806,643,2351,05,34,2018,March,Kent
362,283,236,881,06,34,2018,March,Kent
369,524,327,1220,07,34,2018,March,Kent
781,827,572,2180,08,34,2018,March,Kent
993,685,541,2219,09,34,2018,March,Kent
1093,923,713,2729,10,34,2018,March,Kent
20,29,29,78,11,34,2018,March,Kent
734,709,621,2064,05,11,2018,April,Kent
618,740,620,1978,06,11,2018,April,Kent
783,612,536,1931,07,11,2018,April,Kent
332,300,327,959,08,11,2018,April,Kent
260,462,296,1018,09,11,2018,April,Kent
289,383,309,981,10,11,2018,April,Kent
849,419,506,1774,01,28,2018,April,Kent
758,306,364,1428,02,28,2018,April,Kent
762,543,519,1824,03,28,2018,April,Kent
1229,454,615,2298,04,28,2018,April,Kent
567,324,354,1245,05,28,2018,April,Kent
893,220,403,1516,06,28,2018,April,Kent
737,454,399,1590,07,28,2018,April,Kent
194,217,160,571,08,28,2018,April,Kent
689,218,282,1189,09,28,2018,April,Kent
755,201,283,1239,10,28,2018,April,Kent
203,185,131,519,11,28,2018,April,Kent
98,69,77,244,12,28,2018,April,Kent
262,104,95,461,13,28,2018,April,Kent
429,192,178,799,14,28,2018,April,Kent
1716,753,751,3220,01,29,2018,April,Kent
108,113,93,314,02,29,2018,April,Kent
1102,642,576,2320,03,29,2018,April,Kent
676,444,380,1500,04,29,2018,April,Kent
483,323,332,1138,05,29,2018,April,Kent
1279,536,558,2373,06,29,2018,April,Kent
516,363,296,1175,07,29,2018,April,Kent
803,810,652,2265,08,29,2018,April,Kent
560,768,450,1778,09,29,2018,April,Kent
69,153,109,331,10,29,2018,April,Kent
140,166,119,425,11,29,2018,April,Kent
122,52,65,239,12,29,2018,April,Kent
150,155,113,418,13,29,2018,April,Kent
347,445,374,1166,01,30,2018,April,Kent
197,162,146,505,02,30,2018,April,Kent
642,587,526,1755,03,30,2018,April,Kent
722,647,517,1886,04,30,2018,April,Kent
448,723,550,1721,05,30,2018,April,Kent
201,278,195,674,06,30,2018,April,Kent
151,262,172,585,07,30,2018,April,Kent
892,594,611,2097,08,30,2018,April,Kent
641,589,501,1731,09,30,2018,April,Kent
360,360,289,1009,10,30,2018,April,Kent
333,471,267,1071,11,30,2018,April,Kent
297,537,335,1169,12,30,2018,April,Kent
331,102,142,575,01,31,2018,April,Kent
669,548,451,1668,02,31,2018,April,Kent
1003,356,355,1714,03,31,2018,April,Kent
768,364,404,1536,04,31,2018,April,Kent
916,461,451,1828,05,31,2018,April,Kent
1333,299,502,2134,06,31,2018,April,Kent
1034,293,382,1709,07,31,2018,April,Kent
604,167,281,1052,08,31,2018,April,Kent
459,280,277,1016,09,31,2018,April,Kent
457,202,262,921,10,31,2018,April,Kent
480,317,254,1051,11,31,2018,April,Kent
23,11,12,46,16,31,2018,April,Kent
968,308,456,1732,01,32,2018,April,Kent
632,255,292,1179,02,32,2018,April,Kent
765,367,358,1490,03,32,2018,April,Kent
32,16,13,61,04,32,2018,April,Kent
797,464,478,1739,05,32,2018,April,Kent
134,127,107,368,06,32,2018,April,Kent
1192,445,543,2180,07,32,2018,April,Kent
317,52,126,495,08,32,2018,April,Kent
574,347,435,1356,09,32,2018,April,Kent
397,147,184,728,10,32,2018,April,Kent
683,346,400,1429,11,32,2018,April,Kent
493,422,336,1251,12,32,2018,April,Kent
260,200,152,612,01,33,2018,April,Kent
570,514,440,1524,02,33,2018,April,Kent
764,788,595,2147,03,33,2018,April,Kent
648,868,641,2157,04,33,2018,April,Kent
778,624,609,2011,05,33,2018,April,Kent
96,110,79,285,06,33,2018,April,Kent
386,546,375,1307,07,33,2018,April,Kent
780,852,615,2247,08,33,2018,April,Kent
1181,742,650,2573,09,33,2018,April,Kent
496,620,416,1532,10,33,2018,April,Kent
818,592,610,2020,01,34,2018,April,Kent
374,341,303,1018,02,34,2018,April,Kent
1123,675,635,2433,03,34,2018,April,Kent
265,285,257,807,04,34,2018,April,Kent
903,801,645,2349,05,34,2018,April,Kent
364,287,236,887,06,34,2018,April,Kent
374,523,328,1225,07,34,2018,April,Kent
783,829,572,2184,08,34,2018,April,Kent
988,682,547,2217,09,34,2018,April,Kent
1096,924,716,2736,10,34,2018,April,Kent
20,29,30,79,11,34,2018,April,Kent
730,718,621,2069,05,11,2018,May,Kent
619,739,619,1977,06,11,2018,May,Kent
777,615,542,1934,07,11,2018,May,Kent
332,302,327,961,08,11,2018,May,Kent
258,466,296,1020,09,11,2018,May,Kent
287,383,310,980,10,11,2018,May,Kent
845,420,503,1768,01,28,2018,May,Kent
764,304,371,1439,02,28,2018,May,Kent
770,543,518,1831,03,28,2018,May,Kent
1238,455,626,2319,04,28,2018,May,Kent
569,322,352,1243,05,28,2018,May,Kent
895,222,406,1523,06,28,2018,May,Kent
739,455,403,1597,07,28,2018,May,Kent
196,216,159,571,08,28,2018,May,Kent
695,217,275,1187,09,28,2018,May,Kent
753,199,282,1234,10,28,2018,May,Kent
206,185,131,522,11,28,2018,May,Kent
98,69,77,244,12,28,2018,May,Kent
264,105,96,465,13,28,2018,May,Kent
435,195,180,810,14,28,2018,May,Kent
1723,755,756,3234,01,29,2018,May,Kent
110,114,94,318,02,29,2018,May,Kent
1111,640,580,2331,03,29,2018,May,Kent
682,450,386,1518,04,29,2018,May,Kent
487,326,335,1148,05,29,2018,May,Kent
1281,534,561,2376,06,29,2018,May,Kent
516,367,297,1180,07,29,2018,May,Kent
810,817,648,2275,08,29,2018,May,Kent
568,772,451,1791,09,29,2018,May,Kent
68,156,106,330,10,29,2018,May,Kent
140,167,116,423,11,29,2018,May,Kent
122,51,65,238,12,29,2018,May,Kent
152,156,113,421,13,29,2018,May,Kent
349,445,371,1165,01,30,2018,May,Kent
197,162,147,506,02,30,2018,May,Kent
640,590,522,1752,03,30,2018,May,Kent
723,649,517,1889,04,30,2018,May,Kent
448,728,546,1722,05,30,2018,May,Kent
203,279,195,677,06,30,2018,May,Kent
152,260,173,585,07,30,2018,May,Kent
892,589,613,2094,08,30,2018,May,Kent
640,587,502,1729,09,30,2018,May,Kent
358,363,289,1010,10,30,2018,May,Kent
330,471,269,1070,11,30,2018,May,Kent
297,543,335,1175,12,30,2018,May,Kent
332,103,139,574,01,31,2018,May,Kent
669,552,450,1671,02,31,2018,May,Kent
1003,358,353,1714,03,31,2018,May,Kent
771,371,400,1542,04,31,2018,May,Kent
923,461,450,1834,05,31,2018,May,Kent
1333,299,504,2136,06,31,2018,May,Kent
1043,294,389,1726,07,31,2018,May,Kent
605,166,277,1048,08,31,2018,May,Kent
463,283,278,1024,09,31,2018,May,Kent
459,203,265,927,10,31,2018,May,Kent
479,316,256,1051,11,31,2018,May,Kent
23,11,12,46,16,31,2018,May,Kent
973,314,458,1745,01,32,2018,May,Kent
632,255,294,1181,02,32,2018,May,Kent
768,367,362,1497,03,32,2018,May,Kent
32,16,13,61,04,32,2018,May,Kent
795,467,478,1740,05,32,2018,May,Kent
136,126,110,372,06,32,2018,May,Kent
1204,451,548,2203,07,32,2018,May,Kent
314,52,132,498,08,32,2018,May,Kent
573,350,436,1359,09,32,2018,May,Kent
397,148,188,733,10,32,2018,May,Kent
691,343,393,1427,11,32,2018,May,Kent
496,425,338,1259,12,32,2018,May,Kent
257,201,154,612,01,33,2018,May,Kent
569,519,442,1530,02,33,2018,May,Kent
771,788,594,2153,03,33,2018,May,Kent
649,865,649,2163,04,33,2018,May,Kent
782,625,617,2024,05,33,2018,May,Kent
94,109,79,282,06,33,2018,May,Kent
386,545,380,1311,07,33,2018,May,Kent
782,855,616,2253,08,33,2018,May,Kent
1181,745,652,2578,09,33,2018,May,Kent
497,623,416,1536,10,33,2018,May,Kent
819,594,607,2020,01,34,2018,May,Kent
377,344,308,1029,02,34,2018,May,Kent
1129,675,641,2445,03,34,2018,May,Kent
264,287,257,808,04,34,2018,May,Kent
908,796,645,2349,05,34,2018,May,Kent
365,286,236,887,06,34,2018,May,Kent
373,524,328,1225,07,34,2018,May,Kent
783,828,570,2181,08,34,2018,May,Kent
993,683,548,2224,09,34,2018,May,Kent
1099,934,720,2753,10,34,2018,May,Kent
20,29,29,78,11,34,2018,May,Kent
727,720,616,2063,05,11,2018,June,Kent
617,741,614,1972,06,11,2018,June,Kent
774,616,542,1932,07,11,2018,June,Kent
332,304,325,961,08,11,2018,June,Kent
258,468,294,1020,09,11,2018,June,Kent
284,380,312,976,10,11,2018,June,Kent
847,417,504,1768,01,28,2018,June,Kent
771,305,373,1449,02,28,2018,June,Kent
780,545,520,1845,03,28,2018,June,Kent
1251,451,621,2323,04,28,2018,June,Kent
568,325,353,1246,05,28,2018,June,Kent
896,223,406,1525,06,28,2018,June,Kent
733,456,403,1592,07,28,2018,June,Kent
195,214,157,566,08,28,2018,June,Kent
696,217,271,1184,09,28,2018,June,Kent
754,198,281,1233,10,28,2018,June,Kent
203,185,128,516,11,28,2018,June,Kent
99,67,77,243,12,28,2018,June,Kent
265,105,96,466,13,28,2018,June,Kent
434,198,180,812,14,28,2018,June,Kent
1723,752,752,3227,01,29,2018,June,Kent
110,112,93,315,02,29,2018,June,Kent
1117,633,579,2329,03,29,2018,June,Kent
682,452,388,1522,04,29,2018,June,Kent
487,326,333,1146,05,29,2018,June,Kent
1270,532,559,2361,06,29,2018,June,Kent
508,373,296,1177,07,29,2018,June,Kent
807,813,653,2273,08,29,2018,June,Kent
563,771,449,1783,09,29,2018,June,Kent
66,159,105,330,10,29,2018,June,Kent
139,167,116,422,11,29,2018,June,Kent
122,51,65,238,12,29,2018,June,Kent
152,153,112,417,13,29,2018,June,Kent
348,448,368,1164,01,30,2018,June,Kent
197,162,147,506,02,30,2018,June,Kent
640,595,523,1758,03,30,2018,June,Kent
722,655,513,1890,04,30,2018,June,Kent
444,728,541,1713,05,30,2018,June,Kent
201,284,191,676,06,30,2018,June,Kent
152,258,171,581,07,30,2018,June,Kent
892,589,609,2090,08,30,2018,June,Kent
640,582,500,1722,09,30,2018,June,Kent
355,365,289,1009,10,30,2018,June,Kent
331,477,269,1077,11,30,2018,June,Kent
297,542,329,1168,12,30,2018,June,Kent
334,103,135,572,01,31,2018,June,Kent
668,551,453,1672,02,31,2018,June,Kent
1003,360,353,1716,03,31,2018,June,Kent
759,374,396,1529,04,31,2018,June,Kent
925,457,447,1829,05,31,2018,June,Kent
1341,297,506,2144,06,31,2018,June,Kent
1038,297,395,1730,07,31,2018,June,Kent
602,166,278,1046,08,31,2018,June,Kent
460,284,279,1023,09,31,2018,June,Kent
457,207,264,928,10,31,2018,June,Kent
480,314,257,1051,11,31,2018,June,Kent
22,9,12,43,16,31,2018,June,Kent
977,316,454,1747,01,32,2018,June,Kent
638,257,291,1186,02,32,2018,June,Kent
764,369,367,1500,03,32,2018,June,Kent
33,16,12,61,04,32,2018,June,Kent
794,464,477,1735,05,32,2018,June,Kent
134,130,110,374,06,32,2018,June,Kent
1204,451,550,2205,07,32,2018,June,Kent
311,50,131,492,08,32,2018,June,Kent
576,348,433,1357,09,32,2018,June,Kent
395,146,188,729,10,32,2018,June,Kent
682,343,392,1417,11,32,2018,June,Kent
496,425,333,1254,12,32,2018,June,Kent
260,199,158,617,01,33,2018,June,Kent
565,515,439,1519,02,33,2018,June,Kent
771,786,595,2152,03,33,2018,June,Kent
647,860,635,2142,04,33,2018,June,Kent
785,628,616,2029,05,33,2018,June,Kent
92,109,80,281,06,33,2018,June,Kent
387,551,376,1314,07,33,2018,June,Kent
780,851,611,2242,08,33,2018,June,Kent
1186,740,657,2583,09,33,2018,June,Kent
489,622,414,1525,10,33,2018,June,Kent
824,598,612,2034,01,34,2018,June,Kent
373,346,304,1023,02,34,2018,June,Kent
1121,676,643,2440,03,34,2018,June,Kent
262,282,254,798,04,34,2018,June,Kent
905,790,646,2341,05,34,2018,June,Kent
359,287,237,883,06,34,2018,June,Kent
372,524,328,1224,07,34,2018,June,Kent
776,821,570,2167,08,34,2018,June,Kent
995,676,541,2212,09,34,2018,June,Kent
1102,928,719,2749,10,34,2018,June,Kent
20,29,28,77,11,34,2018,June,Kent
726,723,622,2071,05,11,2018,July,Kent
616,737,614,1967,06,11,2018,July,Kent
770,619,540,1929,07,11,2018,July,Kent
336,304,323,963,08,11,2018,July,Kent
261,468,294,1023,09,11,2018,July,Kent
285,382,312,979,10,11,2018,July,Kent
847,418,507,1772,01,28,2018,July,Kent
769,305,372,1446,02,28,2018,July,Kent
778,540,522,1840,03,28,2018,July,Kent
1265,452,623,2340,04,28,2018,July,Kent
571,323,355,1249,05,28,2018,July,Kent
903,225,407,1535,06,28,2018,July,Kent
729,453,402,1584,07,28,2018,July,Kent
193,216,157,566,08,28,2018,July,Kent
693,216,274,1183,09,28,2018,July,Kent
756,200,280,1236,10,28,2018,July,Kent
204,185,128,517,11,28,2018,July,Kent
101,66,76,243,12,28,2018,July,Kent
267,107,97,471,13,28,2018,July,Kent
430,204,182,816,14,28,2018,July,Kent
1726,758,753,3237,01,29,2018,July,Kent
110,115,93,318,02,29,2018,July,Kent
1116,629,582,2327,03,29,2018,July,Kent
689,454,393,1536,04,29,2018,July,Kent
494,327,331,1152,05,29,2018,July,Kent
1273,537,557,2367,06,29,2018,July,Kent
505,372,296,1173,07,29,2018,July,Kent
806,811,653,2270,08,29,2018,July,Kent
563,773,448,1784,09,29,2018,July,Kent
66,160,107,333,10,29,2018,July,Kent
139,166,118,423,11,29,2018,July,Kent
122,51,64,237,12,29,2018,July,Kent
150,152,112,414,13,29,2018,July,Kent
351,448,369,1168,01,30,2018,July,Kent
196,162,145,503,02,30,2018,July,Kent
638,594,516,1748,03,30,2018,July,Kent
721,653,516,1890,04,30,2018,July,Kent
438,732,546,1716,05,30,2018,July,Kent
200,282,190,672,06,30,2018,July,Kent
153,256,171,580,07,30,2018,July,Kent
898,591,609,2098,08,30,2018,July,Kent
631,582,501,1714,09,30,2018,July,Kent
358,366,289,1013,10,30,2018,July,Kent
331,473,268,1072,11,30,2018,July,Kent
295,543,329,1167,12,30,2018,July,Kent
334,101,135,570,01,31,2018,July,Kent
671,549,454,1674,02,31,2018,July,Kent
1004,359,355,1718,03,31,2018,July,Kent
763,375,398,1536,04,31,2018,July,Kent
933,455,447,1835,05,31,2018,July,Kent
1338,297,505,2140,06,31,2018,July,Kent
1047,297,398,1742,07,31,2018,July,Kent
604,165,282,1051,08,31,2018,July,Kent
457,284,279,1020,09,31,2018,July,Kent
451,209,265,925,10,31,2018,July,Kent
481,312,254,1047,11,31,2018,July,Kent
22,9,12,43,16,31,2018,July,Kent
973,316,457,1746,01,32,2018,July,Kent
637,261,294,1192,02,32,2018,July,Kent
769,370,370,1509,03,32,2018,July,Kent
32,16,12,60,04,32,2018,July,Kent
792,464,477,1733,05,32,2018,July,Kent
135,130,105,370,06,32,2018,July,Kent
1207,456,557,2220,07,32,2018,July,Kent
309,51,132,492,08,32,2018,July,Kent
587,353,436,1376,09,32,2018,July,Kent
394,146,188,728,10,32,2018,July,Kent
682,342,390,1414,11,32,2018,July,Kent
494,430,328,1252,12,32,2018,July,Kent
264,204,163,631,01,33,2018,July,Kent
562,517,437,1516,02,33,2018,July,Kent
777,789,596,2162,03,33,2018,July,Kent
649,864,639,2152,04,33,2018,July,Kent
781,628,619,2028,05,33,2018,July,Kent
92,110,80,282,06,33,2018,July,Kent
389,553,373,1315,07,33,2018,July,Kent
783,855,608,2246,08,33,2018,July,Kent
1184,733,660,2577,09,33,2018,July,Kent
490,623,414,1527,10,33,2018,July,Kent
829,595,619,2043,01,34,2018,July,Kent
371,345,305,1021,02,34,2018,July,Kent
1122,680,645,2447,03,34,2018,July,Kent
262,279,256,797,04,34,2018,July,Kent
906,793,648,2347,05,34,2018,July,Kent
359,286,238,883,06,34,2018,July,Kent
371,522,333,1226,07,34,2018,July,Kent
772,819,573,2164,08,34,2018,July,Kent
997,675,539,2211,09,34,2018,July,Kent
1105,929,716,2750,10,34,2018,July,Kent
20,29,27,76,11,34,2018,July,Kent
728,725,623,2076,05,11,2018,August,Kent
620,737,623,1980,06,11,2018,August,Kent
776,622,543,1941,07,11,2018,August,Kent
341,305,321,967,08,11,2018,August,Kent
257,471,295,1023,09,11,2018,August,Kent
283,381,309,973,10,11,2018,August,Kent
848,419,506,1773,01,28,2018,August,Kent
772,304,370,1446,02,28,2018,August,Kent
780,542,522,1844,03,28,2018,August,Kent
1275,446,622,2343,04,28,2018,August,Kent
567,324,357,1248,05,28,2018,August,Kent
908,223,406,1537,06,28,2018,August,Kent
723,452,401,1576,07,28,2018,August,Kent
191,215,157,563,08,28,2018,August,Kent
695,214,276,1185,09,28,2018,August,Kent
754,200,281,1235,10,28,2018,August,Kent
205,185,128,518,11,28,2018,August,Kent
102,66,76,244,12,28,2018,August,Kent
270,108,98,476,13,28,2018,August,Kent
432,206,183,821,14,28,2018,August,Kent
1732,761,761,3254,01,29,2018,August,Kent
110,115,94,319,02,29,2018,August,Kent
1121,629,583,2333,03,29,2018,August,Kent
695,457,398,1550,04,29,2018,August,Kent
498,331,335,1164,05,29,2018,August,Kent
1274,542,560,2376,06,29,2018,August,Kent
506,371,298,1175,07,29,2018,August,Kent
807,808,647,2262,08,29,2018,August,Kent
565,772,444,1781,09,29,2018,August,Kent
67,161,108,336,10,29,2018,August,Kent
135,167,117,419,11,29,2018,August,Kent
123,51,65,239,12,29,2018,August,Kent
150,153,107,410,13,29,2018,August,Kent
351,452,368,1171,01,30,2018,August,Kent
197,161,146,504,02,30,2018,August,Kent
641,597,520,1758,03,30,2018,August,Kent
719,652,510,1881,04,30,2018,August,Kent
437,732,547,1716,05,30,2018,August,Kent
201,282,190,673,06,30,2018,August,Kent
153,256,170,579,07,30,2018,August,Kent
894,590,611,2095,08,30,2018,August,Kent
632,585,502,1719,09,30,2018,August,Kent
356,364,290,1010,10,30,2018,August,Kent
333,472,266,1071,11,30,2018,August,Kent
297,544,331,1172,12,30,2018,August,Kent
328,102,136,566,01,31,2018,August,Kent
671,546,460,1677,02,31,2018,August,Kent
999,358,353,1710,03,31,2018,August,Kent
767,374,402,1543,04,31,2018,August,Kent
937,454,446,1837,05,31,2018,August,Kent
1338,298,507,2143,06,31,2018,August,Kent
1054,297,406,1757,07,31,2018,August,Kent
608,164,284,1056,08,31,2018,August,Kent
459,281,278,1018,09,31,2018,August,Kent
448,209,266,923,10,31,2018,August,Kent
484,314,254,1052,11,31,2018,August,Kent
21,9,12,42,16,31,2018,August,Kent
975,315,453,1743,01,32,2018,August,Kent
634,260,294,1188,02,32,2018,August,Kent
772,366,369,1507,03,32,2018,August,Kent
32,16,12,60,04,32,2018,August,Kent
791,465,480,1736,05,32,2018,August,Kent
138,131,107,376,06,32,2018,August,Kent
1218,454,566,2238,07,32,2018,August,Kent
309,51,129,489,08,32,2018,August,Kent
589,355,436,1380,09,32,2018,August,Kent
390,146,186,722,10,32,2018,August,Kent
686,345,391,1422,11,32,2018,August,Kent
496,433,331,1260,12,32,2018,August,Kent
264,206,163,633,01,33,2018,August,Kent
567,518,440,1525,02,33,2018,August,Kent
775,787,592,2154,03,33,2018,August,Kent
650,862,639,2151,04,33,2018,August,Kent
788,632,622,2042,05,33,2018,August,Kent
92,111,81,284,06,33,2018,August,Kent
388,544,376,1308,07,33,2018,August,Kent
782,860,608,2250,08,33,2018,August,Kent
1187,726,654,2567,09,33,2018,August,Kent
491,619,413,1523,10,33,2018,August,Kent
831,593,623,2047,01,34,2018,August,Kent
372,346,306,1024,02,34,2018,August,Kent
1130,680,644,2454,03,34,2018,August,Kent
262,282,259,803,04,34,2018,August,Kent
912,792,655,2359,05,34,2018,August,Kent
361,288,240,889,06,34,2018,August,Kent
372,527,333,1232,07,34,2018,August,Kent
774,827,574,2175,08,34,2018,August,Kent
1002,677,537,2216,09,34,2018,August,Kent
1111,936,721,2768,10,34,2018,August,Kent
18,29,26,73,11,34,2018,August,Kent
731,735,619,2085,05,11,2018,September,Kent
615,739,621,1975,06,11,2018,September,Kent
771,628,541,1940,07,11,2018,September,Kent
343,307,318,968,08,11,2018,September,Kent
257,471,296,1024,09,11,2018,September,Kent
282,381,308,971,10,11,2018,September,Kent
841,422,505,1768,01,28,2018,September,Kent
771,300,372,1443,02,28,2018,September,Kent
733,529,507,1769,03,28,2018,September,Kent
1270,447,622,2339,04,28,2018,September,Kent
564,326,364,1254,05,28,2018,September,Kent
910,226,400,1536,06,28,2018,September,Kent
726,449,398,1573,07,28,2018,September,Kent
193,215,157,565,08,28,2018,September,Kent
696,211,279,1186,09,28,2018,September,Kent
753,202,280,1235,10,28,2018,September,Kent
205,184,127,516,11,28,2018,September,Kent
103,67,78,248,12,28,2018,September,Kent
271,107,98,476,13,28,2018,September,Kent
425,204,183,812,14,28,2018,September,Kent
1788,774,782,3344,01,29,2018,September,Kent
111,111,99,321,02,29,2018,September,Kent
1126,630,579,2335,03,29,2018,September,Kent
707,460,398,1565,04,29,2018,September,Kent
497,335,336,1168,05,29,2018,September,Kent
1278,540,564,2382,06,29,2018,September,Kent
507,371,297,1175,07,29,2018,September,Kent
804,808,642,2254,08,29,2018,September,Kent
565,775,444,1784,09,29,2018,September,Kent
65,161,107,333,10,29,2018,September,Kent
130,167,115,412,11,29,2018,September,Kent
123,51,64,238,12,29,2018,September,Kent
150,154,106,410,13,29,2018,September,Kent
349,444,369,1162,01,30,2018,September,Kent
197,162,145,504,02,30,2018,September,Kent
643,597,520,1760,03,30,2018,September,Kent
719,654,514,1887,04,30,2018,September,Kent
439,735,545,1719,05,30,2018,September,Kent
204,284,192,680,06,30,2018,September,Kent
153,257,169,579,07,30,2018,September,Kent
892,588,610,2090,08,30,2018,September,Kent
633,585,504,1722,09,30,2018,September,Kent
357,373,294,1024,10,30,2018,September,Kent
336,470,263,1069,11,30,2018,September,Kent
298,546,329,1173,12,30,2018,September,Kent
332,101,139,572,01,31,2018,September,Kent
669,539,461,1669,02,31,2018,September,Kent
993,356,356,1705,03,31,2018,September,Kent
774,377,400,1551,04,31,2018,September,Kent
939,445,447,1831,05,31,2018,September,Kent
1333,299,510,2142,06,31,2018,September,Kent
1063,294,412,1769,07,31,2018,September,Kent
615,166,283,1064,08,31,2018,September,Kent
471,284,280,1035,09,31,2018,September,Kent
450,208,265,923,10,31,2018,September,Kent
482,308,251,1041,11,31,2018,September,Kent
21,9,12,42,16,31,2018,September,Kent
975,309,453,1737,01,32,2018,September,Kent
626,260,294,1180,02,32,2018,September,Kent
766,368,368,1502,03,32,2018,September,Kent
33,15,12,60,04,32,2018,September,Kent
804,462,477,1743,05,32,2018,September,Kent
139,127,109,375,06,32,2018,September,Kent
1218,458,564,2240,07,32,2018,September,Kent
310,52,132,494,08,32,2018,September,Kent
591,350,438,1379,09,32,2018,September,Kent
385,146,188,719,10,32,2018,September,Kent
687,344,395,1426,11,32,2018,September,Kent
501,431,328,1260,12,32,2018,September,Kent
265,205,165,635,01,33,2018,September,Kent
563,515,437,1515,02,33,2018,September,Kent
770,782,584,2136,03,33,2018,September,Kent
650,859,638,2147,04,33,2018,September,Kent
795,646,618,2059,05,33,2018,September,Kent
91,110,81,282,06,33,2018,September,Kent
387,542,375,1304,07,33,2018,September,Kent
781,853,604,2238,08,33,2018,September,Kent
1181,722,658,2561,09,33,2018,September,Kent
491,617,414,1522,10,33,2018,September,Kent
833,587,622,2042,01,34,2018,September,Kent
375,347,306,1028,02,34,2018,September,Kent
1145,685,640,2470,03,34,2018,September,Kent
261,280,259,800,04,34,2018,September,Kent
912,788,654,2354,05,34,2018,September,Kent
363,284,246,893,06,34,2018,September,Kent
371,524,334,1229,07,34,2018,September,Kent
775,827,576,2178,08,34,2018,September,Kent
1003,676,537,2216,09,34,2018,September,Kent
1110,935,722,2767,10,34,2018,September,Kent
17,30,26,73,11,34,2018,September,Kent
729,747,616,2092,05,11,2018,October,Kent
608,748,619,1975,06,11,2018,October,Kent
767,631,544,1942,07,11,2018,October,Kent
343,313,320,976,08,11,2018,October,Kent
257,476,289,1022,09,11,2018,October,Kent
283,385,307,975,10,11,2018,October,Kent
842,419,502,1763,01,28,2018,October,Kent
770,300,371,1441,02,28,2018,October,Kent
729,543,497,1769,03,28,2018,October,Kent
1282,466,612,2360,04,28,2018,October,Kent
564,327,369,1260,05,28,2018,October,Kent
913,232,404,1549,06,28,2018,October,Kent
731,453,391,1575,07,28,2018,October,Kent
193,219,153,565,08,28,2018,October,Kent
693,209,276,1178,09,28,2018,October,Kent
748,203,281,1232,10,28,2018,October,Kent
206,185,127,518,11,28,2018,October,Kent
105,66,79,250,12,28,2018,October,Kent
275,107,97,479,13,28,2018,October,Kent
420,214,181,815,14,28,2018,October,Kent
1799,779,782,3360,01,29,2018,October,Kent
108,113,100,321,02,29,2018,October,Kent
1131,644,581,2356,03,29,2018,October,Kent
729,466,403,1598,04,29,2018,October,Kent
501,341,334,1176,05,29,2018,October,Kent
1281,546,561,2388,06,29,2018,October,Kent
507,371,297,1175,07,29,2018,October,Kent
814,817,640,2271,08,29,2018,October,Kent
558,779,438,1775,09,29,2018,October,Kent
65,164,107,336,10,29,2018,October,Kent
129,167,115,411,11,29,2018,October,Kent
121,51,66,238,12,29,2018,October,Kent
149,155,107,411,13,29,2018,October,Kent
351,444,375,1170,01,30,2018,October,Kent
201,167,145,513,02,30,2018,October,Kent
642,599,527,1768,03,30,2018,October,Kent
717,668,519,1904,04,30,2018,October,Kent
433,736,537,1706,05,30,2018,October,Kent
205,290,188,683,06,30,2018,October,Kent
153,259,168,580,07,30,2018,October,Kent
895,593,615,2103,08,30,2018,October,Kent
638,590,497,1725,09,30,2018,October,Kent
355,384,291,1030,10,30,2018,October,Kent
334,478,262,1074,11,30,2018,October,Kent
296,548,330,1174,12,30,2018,October,Kent
333,101,141,575,01,31,2018,October,Kent
672,537,459,1668,02,31,2018,October,Kent
998,361,348,1707,03,31,2018,October,Kent
799,377,397,1573,04,31,2018,October,Kent
956,451,441,1848,05,31,2018,October,Kent
1348,298,509,2155,06,31,2018,October,Kent
1073,294,417,1784,07,31,2018,October,Kent
617,169,274,1060,08,31,2018,October,Kent
478,285,277,1040,09,31,2018,October,Kent
455,208,269,932,10,31,2018,October,Kent
489,312,252,1053,11,31,2018,October,Kent
21,8,12,41,16,31,2018,October,Kent
977,313,448,1738,01,32,2018,October,Kent
627,260,295,1182,02,32,2018,October,Kent
761,369,369,1499,03,32,2018,October,Kent
33,14,12,59,04,32,2018,October,Kent
808,468,478,1754,05,32,2018,October,Kent
139,127,107,373,06,32,2018,October,Kent
1231,453,569,2253,07,32,2018,October,Kent
313,53,133,499,08,32,2018,October,Kent
604,355,440,1399,09,32,2018,October,Kent
383,147,188,718,10,32,2018,October,Kent
687,354,392,1433,11,32,2018,October,Kent
504,435,331,1270,12,32,2018,October,Kent
262,206,165,633,01,33,2018,October,Kent
557,523,439,1519,02,33,2018,October,Kent
778,785,584,2147,03,33,2018,October,Kent
653,864,637,2154,04,33,2018,October,Kent
802,662,621,2085,05,33,2018,October,Kent
90,110,80,280,06,33,2018,October,Kent
387,543,382,1312,07,33,2018,October,Kent
775,863,606,2244,08,33,2018,October,Kent
1190,719,653,2562,09,33,2018,October,Kent
487,616,416,1519,10,33,2018,October,Kent
839,593,622,2054,01,34,2018,October,Kent
382,348,301,1031,02,34,2018,October,Kent
1144,689,645,2478,03,34,2018,October,Kent
265,280,257,802,04,34,2018,October,Kent
916,795,648,2359,05,34,2018,October,Kent
363,291,237,891,06,34,2018,October,Kent
379,524,329,1232,07,34,2018,October,Kent
789,823,574,2186,08,34,2018,October,Kent
1012,675,534,2221,09,34,2018,October,Kent
1115,939,723,2777,10,34,2018,October,Kent
17,31,26,74,11,34,2018,October,Kent
723,757,620,2100,05,11,2018,November,Kent
608,745,622,1975,06,11,2018,November,Kent
761,636,543,1940,07,11,2018,November,Kent
348,314,317,979,08,11,2018,November,Kent
256,475,286,1017,09,11,2018,November,Kent
279,392,301,972,10,11,2018,November,Kent
839,427,500,1766,01,28,2018,November,Kent
763,302,374,1439,02,28,2018,November,Kent
738,546,501,1785,03,28,2018,November,Kent
1293,461,616,2370,04,28,2018,November,Kent
561,327,374,1262,05,28,2018,November,Kent
903,234,408,1545,06,28,2018,November,Kent
733,449,391,1573,07,28,2018,November,Kent
194,222,154,570,08,28,2018,November,Kent
699,207,277,1183,09,28,2018,November,Kent
753,201,281,1235,10,28,2018,November,Kent
203,183,128,514,11,28,2018,November,Kent
104,67,78,249,12,28,2018,November,Kent
278,104,101,483,13,28,2018,November,Kent
417,214,178,809,14,28,2018,November,Kent
1803,789,782,3374,01,29,2018,November,Kent
112,116,100,328,02,29,2018,November,Kent
1131,648,579,2358,03,29,2018,November,Kent
736,467,410,1613,04,29,2018,November,Kent
503,343,331,1177,05,29,2018,November,Kent
1290,544,563,2397,06,29,2018,November,Kent
507,376,295,1178,07,29,2018,November,Kent
819,824,641,2284,08,29,2018,November,Kent
557,775,447,1779,09,29,2018,November,Kent
64,165,108,337,10,29,2018,November,Kent
128,166,115,409,11,29,2018,November,Kent
120,51,70,241,12,29,2018,November,Kent
150,154,106,410,13,29,2018,November,Kent
352,448,374,1174,01,30,2018,November,Kent
203,166,146,515,02,30,2018,November,Kent
646,608,518,1772,03,30,2018,November,Kent
726,670,518,1914,04,30,2018,November,Kent
427,749,533,1709,05,30,2018,November,Kent
208,293,188,689,06,30,2018,November,Kent
153,257,169,579,07,30,2018,November,Kent
903,599,614,2116,08,30,2018,November,Kent
637,589,501,1727,09,30,2018,November,Kent
353,381,292,1026,10,30,2018,November,Kent
334,479,261,1074,11,30,2018,November,Kent
298,553,330,1181,12,30,2018,November,Kent
338,103,145,586,01,31,2018,November,Kent
672,537,457,1666,02,31,2018,November,Kent
1000,362,343,1705,03,31,2018,November,Kent
810,382,404,1596,04,31,2018,November,Kent
962,455,440,1857,05,31,2018,November,Kent
1351,296,511,2158,06,31,2018,November,Kent
1081,286,420,1787,07,31,2018,November,Kent
617,172,273,1062,08,31,2018,November,Kent
486,282,280,1048,09,31,2018,November,Kent
449,213,266,928,10,31,2018,November,Kent
492,310,247,1049,11,31,2018,November,Kent
22,8,12,42,16,31,2018,November,Kent
984,315,453,1752,01,32,2018,November,Kent
631,257,292,1180,02,32,2018,November,Kent
764,370,369,1503,03,32,2018,November,Kent
33,14,12,59,04,32,2018,November,Kent
808,475,477,1760,05,32,2018,November,Kent
142,129,110,381,06,32,2018,November,Kent
1247,448,588,2283,07,32,2018,November,Kent
318,55,135,508,08,32,2018,November,Kent
603,355,444,1402,09,32,2018,November,Kent
381,148,192,721,10,32,2018,November,Kent
694,356,396,1446,11,32,2018,November,Kent
506,448,335,1289,12,32,2018,November,Kent
262,207,167,636,01,33,2018,November,Kent
560,521,434,1515,02,33,2018,November,Kent
781,784,589,2154,03,33,2018,November,Kent
651,864,635,2150,04,33,2018,November,Kent
821,666,627,2114,05,33,2018,November,Kent
89,107,81,277,06,33,2018,November,Kent
390,545,378,1313,07,33,2018,November,Kent
773,866,613,2252,08,33,2018,November,Kent
1192,717,656,2565,09,33,2018,November,Kent
481,620,417,1518,10,33,2018,November,Kent
840,594,617,2051,01,34,2018,November,Kent
382,350,298,1030,02,34,2018,November,Kent
1145,684,646,2475,03,34,2018,November,Kent
267,280,256,803,04,34,2018,November,Kent
928,795,646,2369,05,34,2018,November,Kent
366,292,241,899,06,34,2018,November,Kent
380,522,331,1233,07,34,2018,November,Kent
794,811,571,2176,08,34,2018,November,Kent
1014,677,534,2225,09,34,2018,November,Kent
1140,943,730,2813,10,34,2018,November,Kent
18,31,27,76,11,34,2018,November,Kent
900,81,177,1158,01,01,2018,January,New Castle
1571,65,190,1826,02,01,2018,January,New Castle
1117,73,169,1359,03,01,2018,January,New Castle
1576,102,274,1952,04,01,2018,January,New Castle
1225,202,335,1762,05,01,2018,January,New Castle
570,47,111,728,06,01,2018,January,New Castle
655,57,144,856,07,01,2018,January,New Castle
149,61,55,265,08,01,2018,January,New Castle
994,105,162,1261,09,01,2018,January,New Castle
1514,76,216,1806,10,01,2018,January,New Castle
726,66,167,959,11,01,2018,January,New Castle
379,120,173,672,12,01,2018,January,New Castle
849,152,209,1210,13,01,2018,January,New Castle
476,229,242,947,14,01,2018,January,New Castle
1865,115,309,2289,01,02,2018,January,New Castle
635,31,97,763,02,02,2018,January,New Castle
224,54,81,359,03,02,2018,January,New Castle
66,33,22,121,04,02,2018,January,New Castle
1034,107,234,1375,05,02,2018,January,New Castle
839,118,304,1261,06,02,2018,January,New Castle
883,122,228,1233,07,02,2018,January,New Castle
943,59,170,1172,08,02,2018,January,New Castle
519,213,238,970,09,02,2018,January,New Castle
1127,195,438,1760,10,02,2018,January,New Castle
1495,68,235,1798,11,02,2018,January,New Castle
941,51,163,1155,12,02,2018,January,New Castle
378,88,209,675,17,02,2018,January,New Castle
1062,93,231,1386,01,03,2018,January,New Castle
1252,234,317,1803,02,03,2018,January,New Castle
585,56,153,794,03,03,2018,January,New Castle
1348,114,272,1734,04,03,2018,January,New Castle
133,9,33,175,05,03,2018,January,New Castle
1189,109,295,1593,06,03,2018,January,New Castle
1643,167,372,2182,07,03,2018,January,New Castle
1087,188,292,1567,08,03,2018,January,New Castle
1551,172,376,2099,09,03,2018,January,New Castle
271,71,94,436,10,03,2018,January,New Castle
1155,351,405,1911,01,04,2018,January,New Castle
592,649,411,1652,02,04,2018,January,New Castle
1019,372,317,1708,03,04,2018,January,New Castle
544,150,185,879,04,04,2018,January,New Castle
287,40,74,401,05,04,2018,January,New Castle
820,303,373,1496,06,04,2018,January,New Castle
965,332,385,1682,07,04,2018,January,New Castle
942,708,748,2398,08,04,2018,January,New Castle
636,89,208,933,09,04,2018,January,New Castle
222,52,67,341,10,04,2018,January,New Castle
559,588,417,1564,11,04,2018,January,New Castle
632,579,496,1707,12,04,2018,January,New Castle
178,51,78,307,13,04,2018,January,New Castle
196,48,60,304,14,04,2018,January,New Castle
214,242,169,625,15,04,2018,January,New Castle
120,28,48,196,16,04,2018,January,New Castle
1448,307,419,2174,01,05,2018,January,New Castle
742,230,293,1265,02,05,2018,January,New Castle
909,161,242,1312,03,05,2018,January,New Castle
1255,142,331,1728,04,05,2018,January,New Castle
971,151,331,1453,05,05,2018,January,New Castle
1104,164,259,1527,06,05,2018,January,New Castle
712,210,308,1230,07,05,2018,January,New Castle
1378,412,494,2284,08,05,2018,January,New Castle
1085,145,223,1453,09,05,2018,January,New Castle
1151,149,288,1588,10,05,2018,January,New Castle
605,334,367,1306,01,06,2018,January,New Castle
695,603,450,1748,02,06,2018,January,New Castle
174,135,110,419,03,06,2018,January,New Castle
672,303,375,1350,04,06,2018,January,New Castle
1156,336,416,1908,05,06,2018,January,New Castle
648,144,196,988,06,06,2018,January,New Castle
491,408,311,1210,07,06,2018,January,New Castle
1002,593,652,2247,08,06,2018,January,New Castle
1026,585,542,2153,09,06,2018,January,New Castle
638,623,450,1711,10,06,2018,January,New Castle
517,451,362,1330,11,06,2018,January,New Castle
725,594,475,1794,12,06,2018,January,New Castle
832,495,479,1806,01,07,2018,January,New Castle
778,608,520,1906,02,07,2018,January,New Castle
661,471,369,1501,03,07,2018,January,New Castle
1428,582,596,2606,04,07,2018,January,New Castle
466,129,267,862,05,07,2018,January,New Castle
532,290,244,1066,06,07,2018,January,New Castle
827,453,402,1682,07,07,2018,January,New Castle
712,573,459,1744,08,07,2018,January,New Castle
719,433,386,1538,09,07,2018,January,New Castle
1354,430,495,2279,10,07,2018,January,New Castle
441,554,368,1363,01,08,2018,January,New Castle
1117,524,516,2157,02,08,2018,January,New Castle
831,417,390,1638,03,08,2018,January,New Castle
1129,239,320,1688,04,08,2018,January,New Castle
1456,586,619,2661,05,08,2018,January,New Castle
871,612,523,2006,06,08,2018,January,New Castle
678,775,462,1915,07,08,2018,January,New Castle
880,537,456,1873,08,08,2018,January,New Castle
151,143,92,386,09,08,2018,January,New Castle
985,423,484,1892,10,08,2018,January,New Castle
703,571,465,1739,01,09,2018,January,New Castle
755,347,363,1465,02,09,2018,January,New Castle
1037,774,607,2418,03,09,2018,January,New Castle
412,434,257,1103,04,09,2018,January,New Castle
477,286,237,1000,05,09,2018,January,New Castle
590,506,456,1552,06,09,2018,January,New Castle
282,289,197,768,07,09,2018,January,New Castle
672,346,340,1358,08,09,2018,January,New Castle
540,520,407,1467,09,09,2018,January,New Castle
699,397,374,1470,10,09,2018,January,New Castle
814,818,667,2299,11,09,2018,January,New Castle
583,397,360,1340,12,09,2018,January,New Castle
775,493,479,1747,13,09,2018,January,New Castle
792,702,488,1982,01,10,2018,January,New Castle
665,483,383,1531,02,10,2018,January,New Castle
556,483,390,1429,03,10,2018,January,New Castle
1124,485,456,2065,04,10,2018,January,New Castle
581,604,412,1597,05,10,2018,January,New Castle
625,631,418,1674,06,10,2018,January,New Castle
779,650,550,1979,07,10,2018,January,New Castle
1079,242,368,1689,08,10,2018,January,New Castle
574,482,352,1408,09,10,2018,January,New Castle
741,187,271,1199,10,10,2018,January,New Castle
771,495,443,1709,01,11,2018,January,New Castle
1135,447,560,2142,02,11,2018,January,New Castle
614,616,561,1791,03,11,2018,January,New Castle
532,332,335,1199,04,11,2018,January,New Castle
720,529,493,1742,01,12,2018,January,New Castle
561,447,363,1371,02,12,2018,January,New Castle
508,410,382,1300,03,12,2018,January,New Castle
377,606,275,1258,04,12,2018,January,New Castle
653,691,474,1818,05,12,2018,January,New Castle
258,356,185,799,06,12,2018,January,New Castle
552,447,378,1377,07,12,2018,January,New Castle
546,683,479,1708,08,12,2018,January,New Castle
535,461,429,1425,09,12,2018,January,New Castle
665,661,518,1844,10,12,2018,January,New Castle
435,753,407,1595,11,12,2018,January,New Castle
470,549,462,1481,12,12,2018,January,New Castle
372,493,259,1124,13,12,2018,January,New Castle
394,373,295,1062,14,12,2018,January,New Castle
921,411,571,1903,01,13,2018,January,New Castle
658,271,387,1316,02,13,2018,January,New Castle
402,51,82,535,03,13,2018,January,New Castle
864,386,520,1770,04,13,2018,January,New Castle
996,372,561,1929,05,13,2018,January,New Castle
1002,470,612,2084,06,13,2018,January,New Castle
355,130,196,681,07,13,2018,January,New Castle
1324,334,551,2209,08,13,2018,January,New Castle
1038,274,447,1759,09,13,2018,January,New Castle
380,172,239,791,10,13,2018,January,New Castle
455,87,175,717,11,13,2018,January,New Castle
10,2,6,18,12,13,2018,January,New Castle
120,20,37,177,13,13,2018,January,New Castle
1156,536,677,2369,01,15,2018,January,New Castle
1091,595,606,2292,02,15,2018,January,New Castle
1294,478,556,2328,03,15,2018,January,New Castle
627,302,293,1222,04,15,2018,January,New Castle
1634,580,653,2867,05,15,2018,January,New Castle
1093,257,450,1800,06,15,2018,January,New Castle
890,418,438,1746,07,15,2018,January,New Castle
589,321,336,1246,08,15,2018,January,New Castle
317,228,226,771,09,15,2018,January,New Castle
1576,361,563,2500,10,15,2018,January,New Castle
1116,335,450,1901,01,16,2018,January,New Castle
1525,171,353,2049,02,16,2018,January,New Castle
1334,64,189,1587,03,16,2018,January,New Castle
645,150,257,1052,04,16,2018,January,New Castle
1539,130,246,1915,05,16,2018,January,New Castle
1079,137,246,1462,06,16,2018,January,New Castle
928,113,242,1283,07,16,2018,January,New Castle
1437,219,324,1980,08,16,2018,January,New Castle
221,90,89,400,09,16,2018,January,New Castle
1054,271,449,1774,10,16,2018,January,New Castle
845,228,338,1411,01,17,2018,January,New Castle
1970,217,443,2630,02,17,2018,January,New Castle
1325,285,350,1960,03,17,2018,January,New Castle
701,338,334,1373,04,17,2018,January,New Castle
709,276,364,1349,05,17,2018,January,New Castle
95,60,65,220,06,17,2018,January,New Castle
868,256,383,1507,07,17,2018,January,New Castle
662,138,192,992,08,17,2018,January,New Castle
630,262,293,1185,09,17,2018,January,New Castle
922,247,397,1566,10,17,2018,January,New Castle
1170,308,499,1977,11,17,2018,January,New Castle
1433,453,597,2483,01,18,2018,January,New Castle
834,293,403,1530,02,18,2018,January,New Castle
624,234,272,1130,03,18,2018,January,New Castle
1212,370,397,1979,04,18,2018,January,New Castle
895,343,387,1625,05,18,2018,January,New Castle
1192,319,437,1948,06,18,2018,January,New Castle
606,239,335,1180,07,18,2018,January,New Castle
906,225,342,1473,08,18,2018,January,New Castle
749,269,314,1332,09,18,2018,January,New Castle
499,189,209,897,10,18,2018,January,New Castle
885,372,480,1737,01,19,2018,January,New Castle
687,298,388,1373,02,19,2018,January,New Castle
620,429,437,1486,03,19,2018,January,New Castle
869,403,525,1797,04,19,2018,January,New Castle
836,429,526,1791,05,19,2018,January,New Castle
250,91,139,480,06,19,2018,January,New Castle
548,270,302,1120,07,19,2018,January,New Castle
750,410,519,1679,08,19,2018,January,New Castle
720,376,457,1553,09,19,2018,January,New Castle
489,252,310,1051,10,19,2018,January,New Castle
180,87,126,393,11,19,2018,January,New Castle
803,197,301,1301,12,19,2018,January,New Castle
352,280,230,862,01,21,2018,January,New Castle
690,395,442,1527,02,21,2018,January,New Castle
828,575,524,1927,03,21,2018,January,New Castle
844,479,523,1846,04,21,2018,January,New Castle
770,659,532,1961,05,21,2018,January,New Castle
862,569,578,2009,06,21,2018,January,New Castle
53,109,71,233,07,21,2018,January,New Castle
1006,553,625,2184,08,21,2018,January,New Castle
376,273,280,929,09,21,2018,January,New Castle
912,611,593,2116,10,21,2018,January,New Castle
946,519,662,2127,11,21,2018,January,New Castle
563,640,486,1689,01,22,2018,January,New Castle
451,516,431,1398,02,22,2018,January,New Castle
539,619,464,1622,03,22,2018,January,New Castle
501,613,440,1554,04,22,2018,January,New Castle
764,903,648,2315,05,22,2018,January,New Castle
252,276,238,766,06,22,2018,January,New Castle
1080,697,724,2501,07,22,2018,January,New Castle
531,398,376,1305,08,22,2018,January,New Castle
519,480,350,1349,09,22,2018,January,New Castle
520,476,431,1427,10,22,2018,January,New Castle
783,637,589,2009,11,22,2018,January,New Castle
411,428,319,1158,12,22,2018,January,New Castle
281,105,186,572,01,23,2018,January,New Castle
734,524,522,1780,02,23,2018,January,New Castle
547,392,390,1329,03,23,2018,January,New Castle
956,521,494,1971,04,23,2018,January,New Castle
961,326,513,1800,05,23,2018,January,New Castle
695,584,501,1780,06,23,2018,January,New Castle
570,450,428,1448,07,23,2018,January,New Castle
578,460,416,1454,08,23,2018,January,New Castle
188,244,177,609,09,23,2018,January,New Castle
953,479,578,2010,01,24,2018,January,New Castle
1072,389,490,1951,02,24,2018,January,New Castle
691,293,369,1353,03,24,2018,January,New Castle
626,144,246,1016,04,24,2018,January,New Castle
1200,425,580,2205,05,24,2018,January,New Castle
598,390,417,1405,06,24,2018,January,New Castle
1228,325,434,1987,07,24,2018,January,New Castle
874,424,538,1836,08,24,2018,January,New Castle
506,244,268,1018,09,24,2018,January,New Castle
789,335,458,1582,10,24,2018,January,New Castle
760,252,410,1422,01,25,2018,January,New Castle
573,424,408,1405,02,25,2018,January,New Castle
734,351,494,1579,03,25,2018,January,New Castle
678,381,404,1463,04,25,2018,January,New Castle
607,425,446,1478,05,25,2018,January,New Castle
995,417,495,1907,06,25,2018,January,New Castle
843,496,595,1934,07,25,2018,January,New Castle
429,180,218,827,08,25,2018,January,New Castle
876,428,480,1784,01,26,2018,January,New Castle
919,225,362,1506,02,26,2018,January,New Castle
676,258,328,1262,03,26,2018,January,New Castle
1091,350,465,1906,04,26,2018,January,New Castle
1263,387,602,2252,05,26,2018,January,New Castle
979,354,474,1807,06,26,2018,January,New Castle
1188,415,557,2160,07,26,2018,January,New Castle
302,88,134,524,08,26,2018,January,New Castle
1941,336,603,2880,09,26,2018,January,New Castle
1229,605,643,2477,01,27,2018,January,New Castle
744,351,352,1447,02,27,2018,January,New Castle
794,293,364,1451,03,27,2018,January,New Castle
877,496,578,1951,04,27,2018,January,New Castle
937,505,484,1926,05,27,2018,January,New Castle
947,237,373,1557,06,27,2018,January,New Castle
241,238,189,668,07,27,2018,January,New Castle
937,592,570,2099,08,27,2018,January,New Castle
819,644,476,1939,09,27,2018,January,New Castle
829,687,596,2112,10,27,2018,January,New Castle
900,81,177,1158,01,01,2018,Februay,New Castle
1571,65,190,1826,02,01,2018,Februay,New Castle
1117,73,169,1359,03,01,2018,Februay,New Castle
1576,102,274,1952,04,01,2018,Februay,New Castle
1225,202,335,1762,05,01,2018,Februay,New Castle
570,47,111,728,06,01,2018,Februay,New Castle
655,57,144,856,07,01,2018,Februay,New Castle
149,61,55,265,08,01,2018,Februay,New Castle
994,105,162,1261,09,01,2018,Februay,New Castle
1514,76,216,1806,10,01,2018,Februay,New Castle
726,66,167,959,11,01,2018,Februay,New Castle
379,120,173,672,12,01,2018,Februay,New Castle
849,152,209,1210,13,01,2018,Februay,New Castle
476,229,242,947,14,01,2018,Februay,New Castle
1865,115,309,2289,01,02,2018,Februay,New Castle
635,31,97,763,02,02,2018,Februay,New Castle
224,54,81,359,03,02,2018,Februay,New Castle
66,33,22,121,04,02,2018,Februay,New Castle
1034,107,234,1375,05,02,2018,Februay,New Castle
839,118,304,1261,06,02,2018,Februay,New Castle
883,122,228,1233,07,02,2018,Februay,New Castle
943,59,170,1172,08,02,2018,Februay,New Castle
519,213,238,970,09,02,2018,Februay,New Castle
1127,195,438,1760,10,02,2018,Februay,New Castle
1495,68,235,1798,11,02,2018,Februay,New Castle
941,51,163,1155,12,02,2018,Februay,New Castle
378,88,209,675,17,02,2018,Februay,New Castle
1062,93,231,1386,01,03,2018,Februay,New Castle
1252,234,317,1803,02,03,2018,Februay,New Castle
585,56,153,794,03,03,2018,Februay,New Castle
1348,114,272,1734,04,03,2018,Februay,New Castle
133,9,33,175,05,03,2018,Februay,New Castle
1189,109,295,1593,06,03,2018,Februay,New Castle
1643,167,372,2182,07,03,2018,Februay,New Castle
1087,188,292,1567,08,03,2018,Februay,New Castle
1551,172,376,2099,09,03,2018,Februay,New Castle
271,71,94,436,10,03,2018,Februay,New Castle
1155,351,405,1911,01,04,2018,Februay,New Castle
592,649,411,1652,02,04,2018,Februay,New Castle
1019,372,317,1708,03,04,2018,Februay,New Castle
544,150,185,879,04,04,2018,Februay,New Castle
287,40,74,401,05,04,2018,Februay,New Castle
820,303,373,1496,06,04,2018,Februay,New Castle
965,332,385,1682,07,04,2018,Februay,New Castle
942,708,748,2398,08,04,2018,Februay,New Castle
636,89,208,933,09,04,2018,Februay,New Castle
222,52,67,341,10,04,2018,Februay,New Castle
559,588,417,1564,11,04,2018,Februay,New Castle
632,579,496,1707,12,04,2018,Februay,New Castle
178,51,78,307,13,04,2018,Februay,New Castle
196,48,60,304,14,04,2018,Februay,New Castle
214,242,169,625,15,04,2018,Februay,New Castle
120,28,48,196,16,04,2018,Februay,New Castle
1448,307,419,2174,01,05,2018,Februay,New Castle
742,230,293,1265,02,05,2018,Februay,New Castle
909,161,242,1312,03,05,2018,Februay,New Castle
1255,142,331,1728,04,05,2018,Februay,New Castle
971,151,331,1453,05,05,2018,Februay,New Castle
1104,164,259,1527,06,05,2018,Februay,New Castle
712,210,308,1230,07,05,2018,Februay,New Castle
1378,412,494,2284,08,05,2018,Februay,New Castle
1085,145,223,1453,09,05,2018,Februay,New Castle
1151,149,288,1588,10,05,2018,Februay,New Castle
605,334,367,1306,01,06,2018,Februay,New Castle
695,603,450,1748,02,06,2018,Februay,New Castle
174,135,110,419,03,06,2018,Februay,New Castle
672,303,375,1350,04,06,2018,Februay,New Castle
1156,336,416,1908,05,06,2018,Februay,New Castle
648,144,196,988,06,06,2018,Februay,New Castle
491,408,311,1210,07,06,2018,Februay,New Castle
1002,593,652,2247,08,06,2018,Februay,New Castle
1026,585,542,2153,09,06,2018,Februay,New Castle
638,623,450,1711,10,06,2018,Februay,New Castle
517,451,362,1330,11,06,2018,Februay,New Castle
725,594,475,1794,12,06,2018,Februay,New Castle
832,495,479,1806,01,07,2018,Februay,New Castle
778,608,520,1906,02,07,2018,Februay,New Castle
661,471,369,1501,03,07,2018,Februay,New Castle
1428,582,596,2606,04,07,2018,Februay,New Castle
466,129,267,862,05,07,2018,Februay,New Castle
532,290,244,1066,06,07,2018,Februay,New Castle
827,453,402,1682,07,07,2018,Februay,New Castle
712,573,459,1744,08,07,2018,Februay,New Castle
719,433,386,1538,09,07,2018,Februay,New Castle
1354,430,495,2279,10,07,2018,Februay,New Castle
441,554,368,1363,01,08,2018,Februay,New Castle
1117,524,516,2157,02,08,2018,Februay,New Castle
831,417,390,1638,03,08,2018,Februay,New Castle
1129,239,320,1688,04,08,2018,Februay,New Castle
1456,586,619,2661,05,08,2018,Februay,New Castle
871,612,523,2006,06,08,2018,Februay,New Castle
678,775,462,1915,07,08,2018,Februay,New Castle
880,537,456,1873,08,08,2018,Februay,New Castle
151,143,92,386,09,08,2018,Februay,New Castle
985,423,484,1892,10,08,2018,Februay,New Castle
703,571,465,1739,01,09,2018,Februay,New Castle
755,347,363,1465,02,09,2018,Februay,New Castle
1037,774,607,2418,03,09,2018,Februay,New Castle
412,434,257,1103,04,09,2018,Februay,New Castle
477,286,237,1000,05,09,2018,Februay,New Castle
590,506,456,1552,06,09,2018,Februay,New Castle
282,289,197,768,07,09,2018,Februay,New Castle
672,346,340,1358,08,09,2018,Februay,New Castle
540,520,407,1467,09,09,2018,Februay,New Castle
699,397,374,1470,10,09,2018,Februay,New Castle
814,818,667,2299,11,09,2018,Februay,New Castle
583,397,360,1340,12,09,2018,Februay,New Castle
775,493,479,1747,13,09,2018,Februay,New Castle
792,702,488,1982,01,10,2018,Februay,New Castle
665,483,383,1531,02,10,2018,Februay,New Castle
556,483,390,1429,03,10,2018,Februay,New Castle
1124,485,456,2065,04,10,2018,Februay,New Castle
581,604,412,1597,05,10,2018,Februay,New Castle
625,631,418,1674,06,10,2018,Februay,New Castle
779,650,550,1979,07,10,2018,Februay,New Castle
1079,242,368,1689,08,10,2018,Februay,New Castle
574,482,352,1408,09,10,2018,Februay,New Castle
741,187,271,1199,10,10,2018,Februay,New Castle
771,495,443,1709,01,11,2018,Februay,New Castle
1135,447,560,2142,02,11,2018,Februay,New Castle
614,616,561,1791,03,11,2018,Februay,New Castle
532,332,335,1199,04,11,2018,Februay,New Castle
720,529,493,1742,01,12,2018,Februay,New Castle
561,447,363,1371,02,12,2018,Februay,New Castle
508,410,382,1300,03,12,2018,Februay,New Castle
377,606,275,1258,04,12,2018,Februay,New Castle
653,691,474,1818,05,12,2018,Februay,New Castle
258,356,185,799,06,12,2018,Februay,New Castle
552,447,378,1377,07,12,2018,Februay,New Castle
546,683,479,1708,08,12,2018,Februay,New Castle
535,461,429,1425,09,12,2018,Februay,New Castle
665,661,518,1844,10,12,2018,Februay,New Castle
435,753,407,1595,11,12,2018,Februay,New Castle
470,549,462,1481,12,12,2018,Februay,New Castle
372,493,259,1124,13,12,2018,Februay,New Castle
394,373,295,1062,14,12,2018,Februay,New Castle
921,411,571,1903,01,13,2018,Februay,New Castle
658,271,387,1316,02,13,2018,Februay,New Castle
402,51,82,535,03,13,2018,Februay,New Castle
864,386,520,1770,04,13,2018,Februay,New Castle
996,372,561,1929,05,13,2018,Februay,New Castle
1002,470,612,2084,06,13,2018,Februay,New Castle
355,130,196,681,07,13,2018,Februay,New Castle
1324,334,551,2209,08,13,2018,Februay,New Castle
1038,274,447,1759,09,13,2018,Februay,New Castle
380,172,239,791,10,13,2018,Februay,New Castle
455,87,175,717,11,13,2018,Februay,New Castle
10,2,6,18,12,13,2018,Februay,New Castle
120,20,37,177,13,13,2018,Februay,New Castle
1156,536,677,2369,01,15,2018,Februay,New Castle
1091,595,606,2292,02,15,2018,Februay,New Castle
1294,478,556,2328,03,15,2018,Februay,New Castle
627,302,293,1222,04,15,2018,Februay,New Castle
1634,580,653,2867,05,15,2018,Februay,New Castle
1093,257,450,1800,06,15,2018,Februay,New Castle
890,418,438,1746,07,15,2018,Februay,New Castle
589,321,336,1246,08,15,2018,Februay,New Castle
317,228,226,771,09,15,2018,Februay,New Castle
1576,361,563,2500,10,15,2018,Februay,New Castle
1116,335,450,1901,01,16,2018,Februay,New Castle
1525,171,353,2049,02,16,2018,Februay,New Castle
1334,64,189,1587,03,16,2018,Februay,New Castle
645,150,257,1052,04,16,2018,Februay,New Castle
1539,130,246,1915,05,16,2018,Februay,New Castle
1079,137,246,1462,06,16,2018,Februay,New Castle
928,113,242,1283,07,16,2018,Februay,New Castle
1437,219,324,1980,08,16,2018,Februay,New Castle
221,90,89,400,09,16,2018,Februay,New Castle
1054,271,449,1774,10,16,2018,Februay,New Castle
845,228,338,1411,01,17,2018,Februay,New Castle
1970,217,443,2630,02,17,2018,Februay,New Castle
1325,285,350,1960,03,17,2018,Februay,New Castle
701,338,334,1373,04,17,2018,Februay,New Castle
709,276,364,1349,05,17,2018,Februay,New Castle
95,60,65,220,06,17,2018,Februay,New Castle
868,256,383,1507,07,17,2018,Februay,New Castle
662,138,192,992,08,17,2018,Februay,New Castle
630,262,293,1185,09,17,2018,Februay,New Castle
922,247,397,1566,10,17,2018,Februay,New Castle
1170,308,499,1977,11,17,2018,Februay,New Castle
1433,453,597,2483,01,18,2018,Februay,New Castle
834,293,403,1530,02,18,2018,Februay,New Castle
624,234,272,1130,03,18,2018,Februay,New Castle
1212,370,397,1979,04,18,2018,Februay,New Castle
895,343,387,1625,05,18,2018,Februay,New Castle
1192,319,437,1948,06,18,2018,Februay,New Castle
606,239,335,1180,07,18,2018,Februay,New Castle
906,225,342,1473,08,18,2018,Februay,New Castle
749,269,314,1332,09,18,2018,Februay,New Castle
499,189,209,897,10,18,2018,Februay,New Castle
885,372,480,1737,01,19,2018,Februay,New Castle
687,298,388,1373,02,19,2018,Februay,New Castle
620,429,437,1486,03,19,2018,Februay,New Castle
869,403,525,1797,04,19,2018,Februay,New Castle
836,429,526,1791,05,19,2018,Februay,New Castle
250,91,139,480,06,19,2018,Februay,New Castle
548,270,302,1120,07,19,2018,Februay,New Castle
750,410,519,1679,08,19,2018,Februay,New Castle
720,376,457,1553,09,19,2018,Februay,New Castle
489,252,310,1051,10,19,2018,Februay,New Castle
180,87,126,393,11,19,2018,Februay,New Castle
803,197,301,1301,12,19,2018,Februay,New Castle
352,280,230,862,01,21,2018,Februay,New Castle
690,395,442,1527,02,21,2018,Februay,New Castle
828,575,524,1927,03,21,2018,Februay,New Castle
844,479,523,1846,04,21,2018,Februay,New Castle
770,659,532,1961,05,21,2018,Februay,New Castle
862,569,578,2009,06,21,2018,Februay,New Castle
53,109,71,233,07,21,2018,Februay,New Castle
1006,553,625,2184,08,21,2018,Februay,New Castle
376,273,280,929,09,21,2018,Februay,New Castle
912,611,593,2116,10,21,2018,Februay,New Castle
946,519,662,2127,11,21,2018,Februay,New Castle
563,640,486,1689,01,22,2018,Februay,New Castle
451,516,431,1398,02,22,2018,Februay,New Castle
539,619,464,1622,03,22,2018,Februay,New Castle
501,613,440,1554,04,22,2018,Februay,New Castle
764,903,648,2315,05,22,2018,Februay,New Castle
252,276,238,766,06,22,2018,Februay,New Castle
1080,697,724,2501,07,22,2018,Februay,New Castle
531,398,376,1305,08,22,2018,Februay,New Castle
519,480,350,1349,09,22,2018,Februay,New Castle
520,476,431,1427,10,22,2018,Februay,New Castle
783,637,589,2009,11,22,2018,Februay,New Castle
411,428,319,1158,12,22,2018,Februay,New Castle
281,105,186,572,01,23,2018,Februay,New Castle
734,524,522,1780,02,23,2018,Februay,New Castle
547,392,390,1329,03,23,2018,Februay,New Castle
956,521,494,1971,04,23,2018,Februay,New Castle
961,326,513,1800,05,23,2018,Februay,New Castle
695,584,501,1780,06,23,2018,Februay,New Castle
570,450,428,1448,07,23,2018,Februay,New Castle
578,460,416,1454,08,23,2018,Februay,New Castle
188,244,177,609,09,23,2018,Februay,New Castle
953,479,578,2010,01,24,2018,Februay,New Castle
1072,389,490,1951,02,24,2018,Februay,New Castle
691,293,369,1353,03,24,2018,Februay,New Castle
626,144,246,1016,04,24,2018,Februay,New Castle
1200,425,580,2205,05,24,2018,Februay,New Castle
598,390,417,1405,06,24,2018,Februay,New Castle
1228,325,434,1987,07,24,2018,Februay,New Castle
874,424,538,1836,08,24,2018,Februay,New Castle
506,244,268,1018,09,24,2018,Februay,New Castle
789,335,458,1582,10,24,2018,Februay,New Castle
760,252,410,1422,01,25,2018,Februay,New Castle
573,424,408,1405,02,25,2018,Februay,New Castle
734,351,494,1579,03,25,2018,Februay,New Castle
678,381,404,1463,04,25,2018,Februay,New Castle
607,425,446,1478,05,25,2018,Februay,New Castle
995,417,495,1907,06,25,2018,Februay,New Castle
843,496,595,1934,07,25,2018,Februay,New Castle
429,180,218,827,08,25,2018,Februay,New Castle
876,428,480,1784,01,26,2018,Februay,New Castle
919,225,362,1506,02,26,2018,Februay,New Castle
676,258,328,1262,03,26,2018,Februay,New Castle
1091,350,465,1906,04,26,2018,Februay,New Castle
1263,387,602,2252,05,26,2018,Februay,New Castle
979,354,474,1807,06,26,2018,Februay,New Castle
1188,415,557,2160,07,26,2018,Februay,New Castle
302,88,134,524,08,26,2018,Februay,New Castle
1941,336,603,2880,09,26,2018,Februay,New Castle
1229,605,643,2477,01,27,2018,Februay,New Castle
744,351,352,1447,02,27,2018,Februay,New Castle
794,293,364,1451,03,27,2018,Februay,New Castle
877,496,578,1951,04,27,2018,Februay,New Castle
937,505,484,1926,05,27,2018,Februay,New Castle
947,237,373,1557,06,27,2018,Februay,New Castle
241,238,189,668,07,27,2018,Februay,New Castle
937,592,570,2099,08,27,2018,Februay,New Castle
819,644,476,1939,09,27,2018,Februay,New Castle
829,687,596,2112,10,27,2018,Februay,New Castle
900,81,177,1158,01,01,2018,March,New Castle
1571,65,190,1826,02,01,2018,March,New Castle
1117,73,169,1359,03,01,2018,March,New Castle
1576,102,274,1952,04,01,2018,March,New Castle
1225,202,335,1762,05,01,2018,March,New Castle
570,47,111,728,06,01,2018,March,New Castle
655,57,144,856,07,01,2018,March,New Castle
149,61,55,265,08,01,2018,March,New Castle
994,105,162,1261,09,01,2018,March,New Castle
1514,76,216,1806,10,01,2018,March,New Castle
726,66,167,959,11,01,2018,March,New Castle
379,120,173,672,12,01,2018,March,New Castle
849,152,209,1210,13,01,2018,March,New Castle
476,229,242,947,14,01,2018,March,New Castle
1865,115,309,2289,01,02,2018,March,New Castle
635,31,97,763,02,02,2018,March,New Castle
224,54,81,359,03,02,2018,March,New Castle
66,33,22,121,04,02,2018,March,New Castle
1034,107,234,1375,05,02,2018,March,New Castle
839,118,304,1261,06,02,2018,March,New Castle
883,122,228,1233,07,02,2018,March,New Castle
943,59,170,1172,08,02,2018,March,New Castle
519,213,238,970,09,02,2018,March,New Castle
1127,195,438,1760,10,02,2018,March,New Castle
1495,68,235,1798,11,02,2018,March,New Castle
941,51,163,1155,12,02,2018,March,New Castle
378,88,209,675,17,02,2018,March,New Castle
1062,93,231,1386,01,03,2018,March,New Castle
1252,234,317,1803,02,03,2018,March,New Castle
585,56,153,794,03,03,2018,March,New Castle
1348,114,272,1734,04,03,2018,March,New Castle
133,9,33,175,05,03,2018,March,New Castle
1189,109,295,1593,06,03,2018,March,New Castle
1643,167,372,2182,07,03,2018,March,New Castle
1087,188,292,1567,08,03,2018,March,New Castle
1551,172,376,2099,09,03,2018,March,New Castle
271,71,94,436,10,03,2018,March,New Castle
1155,351,405,1911,01,04,2018,March,New Castle
592,649,411,1652,02,04,2018,March,New Castle
1019,372,317,1708,03,04,2018,March,New Castle
544,150,185,879,04,04,2018,March,New Castle
287,40,74,401,05,04,2018,March,New Castle
820,303,373,1496,06,04,2018,March,New Castle
965,332,385,1682,07,04,2018,March,New Castle
942,708,748,2398,08,04,2018,March,New Castle
636,89,208,933,09,04,2018,March,New Castle
222,52,67,341,10,04,2018,March,New Castle
559,588,417,1564,11,04,2018,March,New Castle
632,579,496,1707,12,04,2018,March,New Castle
178,51,78,307,13,04,2018,March,New Castle
196,48,60,304,14,04,2018,March,New Castle
214,242,169,625,15,04,2018,March,New Castle
120,28,48,196,16,04,2018,March,New Castle
1448,307,419,2174,01,05,2018,March,New Castle
742,230,293,1265,02,05,2018,March,New Castle
909,161,242,1312,03,05,2018,March,New Castle
1255,142,331,1728,04,05,2018,March,New Castle
971,151,331,1453,05,05,2018,March,New Castle
1104,164,259,1527,06,05,2018,March,New Castle
712,210,308,1230,07,05,2018,March,New Castle
1378,412,494,2284,08,05,2018,March,New Castle
1085,145,223,1453,09,05,2018,March,New Castle
1151,149,288,1588,10,05,2018,March,New Castle
605,334,367,1306,01,06,2018,March,New Castle
695,603,450,1748,02,06,2018,March,New Castle
174,135,110,419,03,06,2018,March,New Castle
672,303,375,1350,04,06,2018,March,New Castle
1156,336,416,1908,05,06,2018,March,New Castle
648,144,196,988,06,06,2018,March,New Castle
491,408,311,1210,07,06,2018,March,New Castle
1002,593,652,2247,08,06,2018,March,New Castle
1026,585,542,2153,09,06,2018,March,New Castle
638,623,450,1711,10,06,2018,March,New Castle
517,451,362,1330,11,06,2018,March,New Castle
725,594,475,1794,12,06,2018,March,New Castle
832,495,479,1806,01,07,2018,March,New Castle
778,608,520,1906,02,07,2018,March,New Castle
661,471,369,1501,03,07,2018,March,New Castle
1428,582,596,2606,04,07,2018,March,New Castle
466,129,267,862,05,07,2018,March,New Castle
532,290,244,1066,06,07,2018,March,New Castle
827,453,402,1682,07,07,2018,March,New Castle
712,573,459,1744,08,07,2018,March,New Castle
719,433,386,1538,09,07,2018,March,New Castle
1354,430,495,2279,10,07,2018,March,New Castle
441,554,368,1363,01,08,2018,March,New Castle
1117,524,516,2157,02,08,2018,March,New Castle
831,417,390,1638,03,08,2018,March,New Castle
1129,239,320,1688,04,08,2018,March,New Castle
1456,586,619,2661,05,08,2018,March,New Castle
871,612,523,2006,06,08,2018,March,New Castle
678,775,462,1915,07,08,2018,March,New Castle
880,537,456,1873,08,08,2018,March,New Castle
151,143,92,386,09,08,2018,March,New Castle
985,423,484,1892,10,08,2018,March,New Castle
703,571,465,1739,01,09,2018,March,New Castle
755,347,363,1465,02,09,2018,March,New Castle
1037,774,607,2418,03,09,2018,March,New Castle
412,434,257,1103,04,09,2018,March,New Castle
477,286,237,1000,05,09,2018,March,New Castle
590,506,456,1552,06,09,2018,March,New Castle
282,289,197,768,07,09,2018,March,New Castle
672,346,340,1358,08,09,2018,March,New Castle
540,520,407,1467,09,09,2018,March,New Castle
699,397,374,1470,10,09,2018,March,New Castle
814,818,667,2299,11,09,2018,March,New Castle
583,397,360,1340,12,09,2018,March,New Castle
775,493,479,1747,13,09,2018,March,New Castle
792,702,488,1982,01,10,2018,March,New Castle
665,483,383,1531,02,10,2018,March,New Castle
556,483,390,1429,03,10,2018,March,New Castle
1124,485,456,2065,04,10,2018,March,New Castle
581,604,412,1597,05,10,2018,March,New Castle
625,631,418,1674,06,10,2018,March,New Castle
779,650,550,1979,07,10,2018,March,New Castle
1079,242,368,1689,08,10,2018,March,New Castle
574,482,352,1408,09,10,2018,March,New Castle
741,187,271,1199,10,10,2018,March,New Castle
771,495,443,1709,01,11,2018,March,New Castle
1135,447,560,2142,02,11,2018,March,New Castle
614,616,561,1791,03,11,2018,March,New Castle
532,332,335,1199,04,11,2018,March,New Castle
720,529,493,1742,01,12,2018,March,New Castle
561,447,363,1371,02,12,2018,March,New Castle
508,410,382,1300,03,12,2018,March,New Castle
377,606,275,1258,04,12,2018,March,New Castle
653,691,474,1818,05,12,2018,March,New Castle
258,356,185,799,06,12,2018,March,New Castle
552,447,378,1377,07,12,2018,March,New Castle
546,683,479,1708,08,12,2018,March,New Castle
535,461,429,1425,09,12,2018,March,New Castle
665,661,518,1844,10,12,2018,March,New Castle
435,753,407,1595,11,12,2018,March,New Castle
470,549,462,1481,12,12,2018,March,New Castle
372,493,259,1124,13,12,2018,March,New Castle
394,373,295,1062,14,12,2018,March,New Castle
921,411,571,1903,01,13,2018,March,New Castle
658,271,387,1316,02,13,2018,March,New Castle
402,51,82,535,03,13,2018,March,New Castle
864,386,520,1770,04,13,2018,March,New Castle
996,372,561,1929,05,13,2018,March,New Castle
1002,470,612,2084,06,13,2018,March,New Castle
355,130,196,681,07,13,2018,March,New Castle
1324,334,551,2209,08,13,2018,March,New Castle
1038,274,447,1759,09,13,2018,March,New Castle
380,172,239,791,10,13,2018,March,New Castle
455,87,175,717,11,13,2018,March,New Castle
10,2,6,18,12,13,2018,March,New Castle
120,20,37,177,13,13,2018,March,New Castle
1156,536,677,2369,01,15,2018,March,New Castle
1091,595,606,2292,02,15,2018,March,New Castle
1294,478,556,2328,03,15,2018,March,New Castle
627,302,293,1222,04,15,2018,March,New Castle
1634,580,653,2867,05,15,2018,March,New Castle
1093,257,450,1800,06,15,2018,March,New Castle
890,418,438,1746,07,15,2018,March,New Castle
589,321,336,1246,08,15,2018,March,New Castle
317,228,226,771,09,15,2018,March,New Castle
1576,361,563,2500,10,15,2018,March,New Castle
1116,335,450,1901,01,16,2018,March,New Castle
1525,171,353,2049,02,16,2018,March,New Castle
1334,64,189,1587,03,16,2018,March,New Castle
645,150,257,1052,04,16,2018,March,New Castle
1539,130,246,1915,05,16,2018,March,New Castle
1079,137,246,1462,06,16,2018,March,New Castle
928,113,242,1283,07,16,2018,March,New Castle
1437,219,324,1980,08,16,2018,March,New Castle
221,90,89,400,09,16,2018,March,New Castle
1054,271,449,1774,10,16,2018,March,New Castle
845,228,338,1411,01,17,2018,March,New Castle
1970,217,443,2630,02,17,2018,March,New Castle
1325,285,350,1960,03,17,2018,March,New Castle
701,338,334,1373,04,17,2018,March,New Castle
709,276,364,1349,05,17,2018,March,New Castle
95,60,65,220,06,17,2018,March,New Castle
868,256,383,1507,07,17,2018,March,New Castle
662,138,192,992,08,17,2018,March,New Castle
630,262,293,1185,09,17,2018,March,New Castle
922,247,397,1566,10,17,2018,March,New Castle
1170,308,499,1977,11,17,2018,March,New Castle
1433,453,597,2483,01,18,2018,March,New Castle
834,293,403,1530,02,18,2018,March,New Castle
624,234,272,1130,03,18,2018,March,New Castle
1212,370,397,1979,04,18,2018,March,New Castle
895,343,387,1625,05,18,2018,March,New Castle
1192,319,437,1948,06,18,2018,March,New Castle
606,239,335,1180,07,18,2018,March,New Castle
906,225,342,1473,08,18,2018,March,New Castle
749,269,314,1332,09,18,2018,March,New Castle
499,189,209,897,10,18,2018,March,New Castle
885,372,480,1737,01,19,2018,March,New Castle
687,298,388,1373,02,19,2018,March,New Castle
620,429,437,1486,03,19,2018,March,New Castle
869,403,525,1797,04,19,2018,March,New Castle
836,429,526,1791,05,19,2018,March,New Castle
250,91,139,480,06,19,2018,March,New Castle
548,270,302,1120,07,19,2018,March,New Castle
750,410,519,1679,08,19,2018,March,New Castle
720,376,457,1553,09,19,2018,March,New Castle
489,252,310,1051,10,19,2018,March,New Castle
180,87,126,393,11,19,2018,March,New Castle
803,197,301,1301,12,19,2018,March,New Castle
352,280,230,862,01,21,2018,March,New Castle
690,395,442,1527,02,21,2018,March,New Castle
828,575,524,1927,03,21,2018,March,New Castle
844,479,523,1846,04,21,2018,March,New Castle
770,659,532,1961,05,21,2018,March,New Castle
862,569,578,2009,06,21,2018,March,New Castle
53,109,71,233,07,21,2018,March,New Castle
1006,553,625,2184,08,21,2018,March,New Castle
376,273,280,929,09,21,2018,March,New Castle
912,611,593,2116,10,21,2018,March,New Castle
946,519,662,2127,11,21,2018,March,New Castle
563,640,486,1689,01,22,2018,March,New Castle
451,516,431,1398,02,22,2018,March,New Castle
539,619,464,1622,03,22,2018,March,New Castle
501,613,440,1554,04,22,2018,March,New Castle
764,903,648,2315,05,22,2018,March,New Castle
252,276,238,766,06,22,2018,March,New Castle
1080,697,724,2501,07,22,2018,March,New Castle
531,398,376,1305,08,22,2018,March,New Castle
519,480,350,1349,09,22,2018,March,New Castle
520,476,431,1427,10,22,2018,March,New Castle
783,637,589,2009,11,22,2018,March,New Castle
411,428,319,1158,12,22,2018,March,New Castle
281,105,186,572,01,23,2018,March,New Castle
734,524,522,1780,02,23,2018,March,New Castle
547,392,390,1329,03,23,2018,March,New Castle
956,521,494,1971,04,23,2018,March,New Castle
961,326,513,1800,05,23,2018,March,New Castle
695,584,501,1780,06,23,2018,March,New Castle
570,450,428,1448,07,23,2018,March,New Castle
578,460,416,1454,08,23,2018,March,New Castle
188,244,177,609,09,23,2018,March,New Castle
953,479,578,2010,01,24,2018,March,New Castle
1072,389,490,1951,02,24,2018,March,New Castle
691,293,369,1353,03,24,2018,March,New Castle
626,144,246,1016,04,24,2018,March,New Castle
1200,425,580,2205,05,24,2018,March,New Castle
598,390,417,1405,06,24,2018,March,New Castle
1228,325,434,1987,07,24,2018,March,New Castle
874,424,538,1836,08,24,2018,March,New Castle
506,244,268,1018,09,24,2018,March,New Castle
789,335,458,1582,10,24,2018,March,New Castle
760,252,410,1422,01,25,2018,March,New Castle
573,424,408,1405,02,25,2018,March,New Castle
734,351,494,1579,03,25,2018,March,New Castle
678,381,404,1463,04,25,2018,March,New Castle
607,425,446,1478,05,25,2018,March,New Castle
995,417,495,1907,06,25,2018,March,New Castle
843,496,595,1934,07,25,2018,March,New Castle
429,180,218,827,08,25,2018,March,New Castle
876,428,480,1784,01,26,2018,March,New Castle
919,225,362,1506,02,26,2018,March,New Castle
676,258,328,1262,03,26,2018,March,New Castle
1091,350,465,1906,04,26,2018,March,New Castle
1263,387,602,2252,05,26,2018,March,New Castle
979,354,474,1807,06,26,2018,March,New Castle
1188,415,557,2160,07,26,2018,March,New Castle
302,88,134,524,08,26,2018,March,New Castle
1941,336,603,2880,09,26,2018,March,New Castle
1229,605,643,2477,01,27,2018,March,New Castle
744,351,352,1447,02,27,2018,March,New Castle
794,293,364,1451,03,27,2018,March,New Castle
877,496,578,1951,04,27,2018,March,New Castle
937,505,484,1926,05,27,2018,March,New Castle
947,237,373,1557,06,27,2018,March,New Castle
241,238,189,668,07,27,2018,March,New Castle
937,592,570,2099,08,27,2018,March,New Castle
819,644,476,1939,09,27,2018,March,New Castle
829,687,596,2112,10,27,2018,March,New Castle
900,81,177,1158,01,01,2018,April,New Castle
1571,65,190,1826,02,01,2018,April,New Castle
1117,73,169,1359,03,01,2018,April,New Castle
1576,102,274,1952,04,01,2018,April,New Castle
1225,202,335,1762,05,01,2018,April,New Castle
570,47,111,728,06,01,2018,April,New Castle
655,57,144,856,07,01,2018,April,New Castle
149,61,55,265,08,01,2018,April,New Castle
994,105,162,1261,09,01,2018,April,New Castle
1514,76,216,1806,10,01,2018,April,New Castle
726,66,167,959,11,01,2018,April,New Castle
379,120,173,672,12,01,2018,April,New Castle
849,152,209,1210,13,01,2018,April,New Castle
476,229,242,947,14,01,2018,April,New Castle
1865,115,309,2289,01,02,2018,April,New Castle
635,31,97,763,02,02,2018,April,New Castle
224,54,81,359,03,02,2018,April,New Castle
66,33,22,121,04,02,2018,April,New Castle
1034,107,234,1375,05,02,2018,April,New Castle
839,118,304,1261,06,02,2018,April,New Castle
883,122,228,1233,07,02,2018,April,New Castle
943,59,170,1172,08,02,2018,April,New Castle
519,213,238,970,09,02,2018,April,New Castle
1127,195,438,1760,10,02,2018,April,New Castle
1495,68,235,1798,11,02,2018,April,New Castle
941,51,163,1155,12,02,2018,April,New Castle
378,88,209,675,17,02,2018,April,New Castle
1062,93,231,1386,01,03,2018,April,New Castle
1252,234,317,1803,02,03,2018,April,New Castle
585,56,153,794,03,03,2018,April,New Castle
1348,114,272,1734,04,03,2018,April,New Castle
133,9,33,175,05,03,2018,April,New Castle
1189,109,295,1593,06,03,2018,April,New Castle
1643,167,372,2182,07,03,2018,April,New Castle
1087,188,292,1567,08,03,2018,April,New Castle
1551,172,376,2099,09,03,2018,April,New Castle
271,71,94,436,10,03,2018,April,New Castle
1155,351,405,1911,01,04,2018,April,New Castle
592,649,411,1652,02,04,2018,April,New Castle
1019,372,317,1708,03,04,2018,April,New Castle
544,150,185,879,04,04,2018,April,New Castle
287,40,74,401,05,04,2018,April,New Castle
820,303,373,1496,06,04,2018,April,New Castle
965,332,385,1682,07,04,2018,April,New Castle
942,708,748,2398,08,04,2018,April,New Castle
636,89,208,933,09,04,2018,April,New Castle
222,52,67,341,10,04,2018,April,New Castle
559,588,417,1564,11,04,2018,April,New Castle
632,579,496,1707,12,04,2018,April,New Castle
178,51,78,307,13,04,2018,April,New Castle
196,48,60,304,14,04,2018,April,New Castle
214,242,169,625,15,04,2018,April,New Castle
120,28,48,196,16,04,2018,April,New Castle
1448,307,419,2174,01,05,2018,April,New Castle
742,230,293,1265,02,05,2018,April,New Castle
909,161,242,1312,03,05,2018,April,New Castle
1255,142,331,1728,04,05,2018,April,New Castle
971,151,331,1453,05,05,2018,April,New Castle
1104,164,259,1527,06,05,2018,April,New Castle
712,210,308,1230,07,05,2018,April,New Castle
1378,412,494,2284,08,05,2018,April,New Castle
1085,145,223,1453,09,05,2018,April,New Castle
1151,149,288,1588,10,05,2018,April,New Castle
605,334,367,1306,01,06,2018,April,New Castle
695,603,450,1748,02,06,2018,April,New Castle
174,135,110,419,03,06,2018,April,New Castle
672,303,375,1350,04,06,2018,April,New Castle
1156,336,416,1908,05,06,2018,April,New Castle
648,144,196,988,06,06,2018,April,New Castle
491,408,311,1210,07,06,2018,April,New Castle
1002,593,652,2247,08,06,2018,April,New Castle
1026,585,542,2153,09,06,2018,April,New Castle
638,623,450,1711,10,06,2018,April,New Castle
517,451,362,1330,11,06,2018,April,New Castle
725,594,475,1794,12,06,2018,April,New Castle
832,495,479,1806,01,07,2018,April,New Castle
778,608,520,1906,02,07,2018,April,New Castle
661,471,369,1501,03,07,2018,April,New Castle
1428,582,596,2606,04,07,2018,April,New Castle
466,129,267,862,05,07,2018,April,New Castle
532,290,244,1066,06,07,2018,April,New Castle
827,453,402,1682,07,07,2018,April,New Castle
712,573,459,1744,08,07,2018,April,New Castle
719,433,386,1538,09,07,2018,April,New Castle
1354,430,495,2279,10,07,2018,April,New Castle
441,554,368,1363,01,08,2018,April,New Castle
1117,524,516,2157,02,08,2018,April,New Castle
831,417,390,1638,03,08,2018,April,New Castle
1129,239,320,1688,04,08,2018,April,New Castle
1456,586,619,2661,05,08,2018,April,New Castle
871,612,523,2006,06,08,2018,April,New Castle
678,775,462,1915,07,08,2018,April,New Castle
880,537,456,1873,08,08,2018,April,New Castle
151,143,92,386,09,08,2018,April,New Castle
985,423,484,1892,10,08,2018,April,New Castle
703,571,465,1739,01,09,2018,April,New Castle
755,347,363,1465,02,09,2018,April,New Castle
1037,774,607,2418,03,09,2018,April,New Castle
412,434,257,1103,04,09,2018,April,New Castle
477,286,237,1000,05,09,2018,April,New Castle
590,506,456,1552,06,09,2018,April,New Castle
282,289,197,768,07,09,2018,April,New Castle
672,346,340,1358,08,09,2018,April,New Castle
540,520,407,1467,09,09,2018,April,New Castle
699,397,374,1470,10,09,2018,April,New Castle
814,818,667,2299,11,09,2018,April,New Castle
583,397,360,1340,12,09,2018,April,New Castle
775,493,479,1747,13,09,2018,April,New Castle
792,702,488,1982,01,10,2018,April,New Castle
665,483,383,1531,02,10,2018,April,New Castle
556,483,390,1429,03,10,2018,April,New Castle
1124,485,456,2065,04,10,2018,April,New Castle
581,604,412,1597,05,10,2018,April,New Castle
625,631,418,1674,06,10,2018,April,New Castle
779,650,550,1979,07,10,2018,April,New Castle
1079,242,368,1689,08,10,2018,April,New Castle
574,482,352,1408,09,10,2018,April,New Castle
741,187,271,1199,10,10,2018,April,New Castle
771,495,443,1709,01,11,2018,April,New Castle
1135,447,560,2142,02,11,2018,April,New Castle
614,616,561,1791,03,11,2018,April,New Castle
532,332,335,1199,04,11,2018,April,New Castle
720,529,493,1742,01,12,2018,April,New Castle
561,447,363,1371,02,12,2018,April,New Castle
508,410,382,1300,03,12,2018,April,New Castle
377,606,275,1258,04,12,2018,April,New Castle
653,691,474,1818,05,12,2018,April,New Castle
258,356,185,799,06,12,2018,April,New Castle
552,447,378,1377,07,12,2018,April,New Castle
546,683,479,1708,08,12,2018,April,New Castle
535,461,429,1425,09,12,2018,April,New Castle
665,661,518,1844,10,12,2018,April,New Castle
435,753,407,1595,11,12,2018,April,New Castle
470,549,462,1481,12,12,2018,April,New Castle
372,493,259,1124,13,12,2018,April,New Castle
394,373,295,1062,14,12,2018,April,New Castle
921,411,571,1903,01,13,2018,April,New Castle
658,271,387,1316,02,13,2018,April,New Castle
402,51,82,535,03,13,2018,April,New Castle
864,386,520,1770,04,13,2018,April,New Castle
996,372,561,1929,05,13,2018,April,New Castle
1002,470,612,2084,06,13,2018,April,New Castle
355,130,196,681,07,13,2018,April,New Castle
1324,334,551,2209,08,13,2018,April,New Castle
1038,274,447,1759,09,13,2018,April,New Castle
380,172,239,791,10,13,2018,April,New Castle
455,87,175,717,11,13,2018,April,New Castle
10,2,6,18,12,13,2018,April,New Castle
120,20,37,177,13,13,2018,April,New Castle
1156,536,677,2369,01,15,2018,April,New Castle
1091,595,606,2292,02,15,2018,April,New Castle
1294,478,556,2328,03,15,2018,April,New Castle
627,302,293,1222,04,15,2018,April,New Castle
1634,580,653,2867,05,15,2018,April,New Castle
1093,257,450,1800,06,15,2018,April,New Castle
890,418,438,1746,07,15,2018,April,New Castle
589,321,336,1246,08,15,2018,April,New Castle
317,228,226,771,09,15,2018,April,New Castle
1576,361,563,2500,10,15,2018,April,New Castle
1116,335,450,1901,01,16,2018,April,New Castle
1525,171,353,2049,02,16,2018,April,New Castle
1334,64,189,1587,03,16,2018,April,New Castle
645,150,257,1052,04,16,2018,April,New Castle
1539,130,246,1915,05,16,2018,April,New Castle
1079,137,246,1462,06,16,2018,April,New Castle
928,113,242,1283,07,16,2018,April,New Castle
1437,219,324,1980,08,16,2018,April,New Castle
221,90,89,400,09,16,2018,April,New Castle
1054,271,449,1774,10,16,2018,April,New Castle
845,228,338,1411,01,17,2018,April,New Castle
1970,217,443,2630,02,17,2018,April,New Castle
1325,285,350,1960,03,17,2018,April,New Castle
701,338,334,1373,04,17,2018,April,New Castle
709,276,364,1349,05,17,2018,April,New Castle
95,60,65,220,06,17,2018,April,New Castle
868,256,383,1507,07,17,2018,April,New Castle
662,138,192,992,08,17,2018,April,New Castle
630,262,293,1185,09,17,2018,April,New Castle
922,247,397,1566,10,17,2018,April,New Castle
1170,308,499,1977,11,17,2018,April,New Castle
1433,453,597,2483,01,18,2018,April,New Castle
834,293,403,1530,02,18,2018,April,New Castle
624,234,272,1130,03,18,2018,April,New Castle
1212,370,397,1979,04,18,2018,April,New Castle
895,343,387,1625,05,18,2018,April,New Castle
1192,319,437,1948,06,18,2018,April,New Castle
606,239,335,1180,07,18,2018,April,New Castle
906,225,342,1473,08,18,2018,April,New Castle
749,269,314,1332,09,18,2018,April,New Castle
499,189,209,897,10,18,2018,April,New Castle
885,372,480,1737,01,19,2018,April,New Castle
687,298,388,1373,02,19,2018,April,New Castle
620,429,437,1486,03,19,2018,April,New Castle
869,403,525,1797,04,19,2018,April,New Castle
836,429,526,1791,05,19,2018,April,New Castle
250,91,139,480,06,19,2018,April,New Castle
548,270,302,1120,07,19,2018,April,New Castle
750,410,519,1679,08,19,2018,April,New Castle
720,376,457,1553,09,19,2018,April,New Castle
489,252,310,1051,10,19,2018,April,New Castle
180,87,126,393,11,19,2018,April,New Castle
803,197,301,1301,12,19,2018,April,New Castle
352,280,230,862,01,21,2018,April,New Castle
690,395,442,1527,02,21,2018,April,New Castle
828,575,524,1927,03,21,2018,April,New Castle
844,479,523,1846,04,21,2018,April,New Castle
770,659,532,1961,05,21,2018,April,New Castle
862,569,578,2009,06,21,2018,April,New Castle
53,109,71,233,07,21,2018,April,New Castle
1006,553,625,2184,08,21,2018,April,New Castle
376,273,280,929,09,21,2018,April,New Castle
912,611,593,2116,10,21,2018,April,New Castle
946,519,662,2127,11,21,2018,April,New Castle
563,640,486,1689,01,22,2018,April,New Castle
451,516,431,1398,02,22,2018,April,New Castle
539,619,464,1622,03,22,2018,April,New Castle
501,613,440,1554,04,22,2018,April,New Castle
764,903,648,2315,05,22,2018,April,New Castle
252,276,238,766,06,22,2018,April,New Castle
1080,697,724,2501,07,22,2018,April,New Castle
531,398,376,1305,08,22,2018,April,New Castle
519,480,350,1349,09,22,2018,April,New Castle
520,476,431,1427,10,22,2018,April,New Castle
783,637,589,2009,11,22,2018,April,New Castle
411,428,319,1158,12,22,2018,April,New Castle
281,105,186,572,01,23,2018,April,New Castle
734,524,522,1780,02,23,2018,April,New Castle
547,392,390,1329,03,23,2018,April,New Castle
956,521,494,1971,04,23,2018,April,New Castle
961,326,513,1800,05,23,2018,April,New Castle
695,584,501,1780,06,23,2018,April,New Castle
570,450,428,1448,07,23,2018,April,New Castle
578,460,416,1454,08,23,2018,April,New Castle
188,244,177,609,09,23,2018,April,New Castle
953,479,578,2010,01,24,2018,April,New Castle
1072,389,490,1951,02,24,2018,April,New Castle
691,293,369,1353,03,24,2018,April,New Castle
626,144,246,1016,04,24,2018,April,New Castle
1200,425,580,2205,05,24,2018,April,New Castle
598,390,417,1405,06,24,2018,April,New Castle
1228,325,434,1987,07,24,2018,April,New Castle
874,424,538,1836,08,24,2018,April,New Castle
506,244,268,1018,09,24,2018,April,New Castle
789,335,458,1582,10,24,2018,April,New Castle
760,252,410,1422,01,25,2018,April,New Castle
573,424,408,1405,02,25,2018,April,New Castle
734,351,494,1579,03,25,2018,April,New Castle
678,381,404,1463,04,25,2018,April,New Castle
607,425,446,1478,05,25,2018,April,New Castle
995,417,495,1907,06,25,2018,April,New Castle
843,496,595,1934,07,25,2018,April,New Castle
429,180,218,827,08,25,2018,April,New Castle
876,428,480,1784,01,26,2018,April,New Castle
919,225,362,1506,02,26,2018,April,New Castle
676,258,328,1262,03,26,2018,April,New Castle
1091,350,465,1906,04,26,2018,April,New Castle
1263,387,602,2252,05,26,2018,April,New Castle
979,354,474,1807,06,26,2018,April,New Castle
1188,415,557,2160,07,26,2018,April,New Castle
302,88,134,524,08,26,2018,April,New Castle
1941,336,603,2880,09,26,2018,April,New Castle
1229,605,643,2477,01,27,2018,April,New Castle
744,351,352,1447,02,27,2018,April,New Castle
794,293,364,1451,03,27,2018,April,New Castle
877,496,578,1951,04,27,2018,April,New Castle
937,505,484,1926,05,27,2018,April,New Castle
947,237,373,1557,06,27,2018,April,New Castle
241,238,189,668,07,27,2018,April,New Castle
937,592,570,2099,08,27,2018,April,New Castle
819,644,476,1939,09,27,2018,April,New Castle
829,687,596,2112,10,27,2018,April,New Castle
900,81,177,1158,01,01,2018,May,New Castle
1571,65,190,1826,02,01,2018,May,New Castle
1117,73,169,1359,03,01,2018,May,New Castle
1576,102,274,1952,04,01,2018,May,New Castle
1225,202,335,1762,05,01,2018,May,New Castle
570,47,111,728,06,01,2018,May,New Castle
655,57,144,856,07,01,2018,May,New Castle
149,61,55,265,08,01,2018,May,New Castle
994,105,162,1261,09,01,2018,May,New Castle
1514,76,216,1806,10,01,2018,May,New Castle
726,66,167,959,11,01,2018,May,New Castle
379,120,173,672,12,01,2018,May,New Castle
849,152,209,1210,13,01,2018,May,New Castle
476,229,242,947,14,01,2018,May,New Castle
1865,115,309,2289,01,02,2018,May,New Castle
635,31,97,763,02,02,2018,May,New Castle
224,54,81,359,03,02,2018,May,New Castle
66,33,22,121,04,02,2018,May,New Castle
1034,107,234,1375,05,02,2018,May,New Castle
839,118,304,1261,06,02,2018,May,New Castle
883,122,228,1233,07,02,2018,May,New Castle
943,59,170,1172,08,02,2018,May,New Castle
519,213,238,970,09,02,2018,May,New Castle
1127,195,438,1760,10,02,2018,May,New Castle
1495,68,235,1798,11,02,2018,May,New Castle
941,51,163,1155,12,02,2018,May,New Castle
378,88,209,675,17,02,2018,May,New Castle
1062,93,231,1386,01,03,2018,May,New Castle
1252,234,317,1803,02,03,2018,May,New Castle
585,56,153,794,03,03,2018,May,New Castle
1348,114,272,1734,04,03,2018,May,New Castle
133,9,33,175,05,03,2018,May,New Castle
1189,109,295,1593,06,03,2018,May,New Castle
1643,167,372,2182,07,03,2018,May,New Castle
1087,188,292,1567,08,03,2018,May,New Castle
1551,172,376,2099,09,03,2018,May,New Castle
271,71,94,436,10,03,2018,May,New Castle
1155,351,405,1911,01,04,2018,May,New Castle
592,649,411,1652,02,04,2018,May,New Castle
1019,372,317,1708,03,04,2018,May,New Castle
544,150,185,879,04,04,2018,May,New Castle
287,40,74,401,05,04,2018,May,New Castle
820,303,373,1496,06,04,2018,May,New Castle
965,332,385,1682,07,04,2018,May,New Castle
942,708,748,2398,08,04,2018,May,New Castle
636,89,208,933,09,04,2018,May,New Castle
222,52,67,341,10,04,2018,May,New Castle
559,588,417,1564,11,04,2018,May,New Castle
632,579,496,1707,12,04,2018,May,New Castle
178,51,78,307,13,04,2018,May,New Castle
196,48,60,304,14,04,2018,May,New Castle
214,242,169,625,15,04,2018,May,New Castle
120,28,48,196,16,04,2018,May,New Castle
1448,307,419,2174,01,05,2018,May,New Castle
742,230,293,1265,02,05,2018,May,New Castle
909,161,242,1312,03,05,2018,May,New Castle
1255,142,331,1728,04,05,2018,May,New Castle
971,151,331,1453,05,05,2018,May,New Castle
1104,164,259,1527,06,05,2018,May,New Castle
712,210,308,1230,07,05,2018,May,New Castle
1378,412,494,2284,08,05,2018,May,New Castle
1085,145,223,1453,09,05,2018,May,New Castle
1151,149,288,1588,10,05,2018,May,New Castle
605,334,367,1306,01,06,2018,May,New Castle
695,603,450,1748,02,06,2018,May,New Castle
174,135,110,419,03,06,2018,May,New Castle
672,303,375,1350,04,06,2018,May,New Castle
1156,336,416,1908,05,06,2018,May,New Castle
648,144,196,988,06,06,2018,May,New Castle
491,408,311,1210,07,06,2018,May,New Castle
1002,593,652,2247,08,06,2018,May,New Castle
1026,585,542,2153,09,06,2018,May,New Castle
638,623,450,1711,10,06,2018,May,New Castle
517,451,362,1330,11,06,2018,May,New Castle
725,594,475,1794,12,06,2018,May,New Castle
832,495,479,1806,01,07,2018,May,New Castle
778,608,520,1906,02,07,2018,May,New Castle
661,471,369,1501,03,07,2018,May,New Castle
1428,582,596,2606,04,07,2018,May,New Castle
466,129,267,862,05,07,2018,May,New Castle
532,290,244,1066,06,07,2018,May,New Castle
827,453,402,1682,07,07,2018,May,New Castle
712,573,459,1744,08,07,2018,May,New Castle
719,433,386,1538,09,07,2018,May,New Castle
1354,430,495,2279,10,07,2018,May,New Castle
441,554,368,1363,01,08,2018,May,New Castle
1117,524,516,2157,02,08,2018,May,New Castle
831,417,390,1638,03,08,2018,May,New Castle
1129,239,320,1688,04,08,2018,May,New Castle
1456,586,619,2661,05,08,2018,May,New Castle
871,612,523,2006,06,08,2018,May,New Castle
678,775,462,1915,07,08,2018,May,New Castle
880,537,456,1873,08,08,2018,May,New Castle
151,143,92,386,09,08,2018,May,New Castle
985,423,484,1892,10,08,2018,May,New Castle
703,571,465,1739,01,09,2018,May,New Castle
755,347,363,1465,02,09,2018,May,New Castle
1037,774,607,2418,03,09,2018,May,New Castle
412,434,257,1103,04,09,2018,May,New Castle
477,286,237,1000,05,09,2018,May,New Castle
590,506,456,1552,06,09,2018,May,New Castle
282,289,197,768,07,09,2018,May,New Castle
672,346,340,1358,08,09,2018,May,New Castle
540,520,407,1467,09,09,2018,May,New Castle
699,397,374,1470,10,09,2018,May,New Castle
814,818,667,2299,11,09,2018,May,New Castle
583,397,360,1340,12,09,2018,May,New Castle
775,493,479,1747,13,09,2018,May,New Castle
792,702,488,1982,01,10,2018,May,New Castle
665,483,383,1531,02,10,2018,May,New Castle
556,483,390,1429,03,10,2018,May,New Castle
1124,485,456,2065,04,10,2018,May,New Castle
581,604,412,1597,05,10,2018,May,New Castle
625,631,418,1674,06,10,2018,May,New Castle
779,650,550,1979,07,10,2018,May,New Castle
1079,242,368,1689,08,10,2018,May,New Castle
574,482,352,1408,09,10,2018,May,New Castle
741,187,271,1199,10,10,2018,May,New Castle
771,495,443,1709,01,11,2018,May,New Castle
1135,447,560,2142,02,11,2018,May,New Castle
614,616,561,1791,03,11,2018,May,New Castle
532,332,335,1199,04,11,2018,May,New Castle
720,529,493,1742,01,12,2018,May,New Castle
561,447,363,1371,02,12,2018,May,New Castle
508,410,382,1300,03,12,2018,May,New Castle
377,606,275,1258,04,12,2018,May,New Castle
653,691,474,1818,05,12,2018,May,New Castle
258,356,185,799,06,12,2018,May,New Castle
552,447,378,1377,07,12,2018,May,New Castle
546,683,479,1708,08,12,2018,May,New Castle
535,461,429,1425,09,12,2018,May,New Castle
665,661,518,1844,10,12,2018,May,New Castle
435,753,407,1595,11,12,2018,May,New Castle
470,549,462,1481,12,12,2018,May,New Castle
372,493,259,1124,13,12,2018,May,New Castle
394,373,295,1062,14,12,2018,May,New Castle
921,411,571,1903,01,13,2018,May,New Castle
658,271,387,1316,02,13,2018,May,New Castle
402,51,82,535,03,13,2018,May,New Castle
864,386,520,1770,04,13,2018,May,New Castle
996,372,561,1929,05,13,2018,May,New Castle
1002,470,612,2084,06,13,2018,May,New Castle
355,130,196,681,07,13,2018,May,New Castle
1324,334,551,2209,08,13,2018,May,New Castle
1038,274,447,1759,09,13,2018,May,New Castle
380,172,239,791,10,13,2018,May,New Castle
455,87,175,717,11,13,2018,May,New Castle
10,2,6,18,12,13,2018,May,New Castle
120,20,37,177,13,13,2018,May,New Castle
1156,536,677,2369,01,15,2018,May,New Castle
1091,595,606,2292,02,15,2018,May,New Castle
1294,478,556,2328,03,15,2018,May,New Castle
627,302,293,1222,04,15,2018,May,New Castle
1634,580,653,2867,05,15,2018,May,New Castle
1093,257,450,1800,06,15,2018,May,New Castle
890,418,438,1746,07,15,2018,May,New Castle
589,321,336,1246,08,15,2018,May,New Castle
317,228,226,771,09,15,2018,May,New Castle
1576,361,563,2500,10,15,2018,May,New Castle
1116,335,450,1901,01,16,2018,May,New Castle
1525,171,353,2049,02,16,2018,May,New Castle
1334,64,189,1587,03,16,2018,May,New Castle
645,150,257,1052,04,16,2018,May,New Castle
1539,130,246,1915,05,16,2018,May,New Castle
1079,137,246,1462,06,16,2018,May,New Castle
928,113,242,1283,07,16,2018,May,New Castle
1437,219,324,1980,08,16,2018,May,New Castle
221,90,89,400,09,16,2018,May,New Castle
1054,271,449,1774,10,16,2018,May,New Castle
845,228,338,1411,01,17,2018,May,New Castle
1970,217,443,2630,02,17,2018,May,New Castle
1325,285,350,1960,03,17,2018,May,New Castle
701,338,334,1373,04,17,2018,May,New Castle
709,276,364,1349,05,17,2018,May,New Castle
95,60,65,220,06,17,2018,May,New Castle
868,256,383,1507,07,17,2018,May,New Castle
662,138,192,992,08,17,2018,May,New Castle
630,262,293,1185,09,17,2018,May,New Castle
922,247,397,1566,10,17,2018,May,New Castle
1170,308,499,1977,11,17,2018,May,New Castle
1433,453,597,2483,01,18,2018,May,New Castle
834,293,403,1530,02,18,2018,May,New Castle
624,234,272,1130,03,18,2018,May,New Castle
1212,370,397,1979,04,18,2018,May,New Castle
895,343,387,1625,05,18,2018,May,New Castle
1192,319,437,1948,06,18,2018,May,New Castle
606,239,335,1180,07,18,2018,May,New Castle
906,225,342,1473,08,18,2018,May,New Castle
749,269,314,1332,09,18,2018,May,New Castle
499,189,209,897,10,18,2018,May,New Castle
885,372,480,1737,01,19,2018,May,New Castle
687,298,388,1373,02,19,2018,May,New Castle
620,429,437,1486,03,19,2018,May,New Castle
869,403,525,1797,04,19,2018,May,New Castle
836,429,526,1791,05,19,2018,May,New Castle
250,91,139,480,06,19,2018,May,New Castle
548,270,302,1120,07,19,2018,May,New Castle
750,410,519,1679,08,19,2018,May,New Castle
720,376,457,1553,09,19,2018,May,New Castle
489,252,310,1051,10,19,2018,May,New Castle
180,87,126,393,11,19,2018,May,New Castle
803,197,301,1301,12,19,2018,May,New Castle
352,280,230,862,01,21,2018,May,New Castle
690,395,442,1527,02,21,2018,May,New Castle
828,575,524,1927,03,21,2018,May,New Castle
844,479,523,1846,04,21,2018,May,New Castle
770,659,532,1961,05,21,2018,May,New Castle
862,569,578,2009,06,21,2018,May,New Castle
53,109,71,233,07,21,2018,May,New Castle
1006,553,625,2184,08,21,2018,May,New Castle
376,273,280,929,09,21,2018,May,New Castle
912,611,593,2116,10,21,2018,May,New Castle
946,519,662,2127,11,21,2018,May,New Castle
563,640,486,1689,01,22,2018,May,New Castle
451,516,431,1398,02,22,2018,May,New Castle
539,619,464,1622,03,22,2018,May,New Castle
501,613,440,1554,04,22,2018,May,New Castle
764,903,648,2315,05,22,2018,May,New Castle
252,276,238,766,06,22,2018,May,New Castle
1080,697,724,2501,07,22,2018,May,New Castle
531,398,376,1305,08,22,2018,May,New Castle
519,480,350,1349,09,22,2018,May,New Castle
520,476,431,1427,10,22,2018,May,New Castle
783,637,589,2009,11,22,2018,May,New Castle
411,428,319,1158,12,22,2018,May,New Castle
281,105,186,572,01,23,2018,May,New Castle
734,524,522,1780,02,23,2018,May,New Castle
547,392,390,1329,03,23,2018,May,New Castle
956,521,494,1971,04,23,2018,May,New Castle
961,326,513,1800,05,23,2018,May,New Castle
695,584,501,1780,06,23,2018,May,New Castle
570,450,428,1448,07,23,2018,May,New Castle
578,460,416,1454,08,23,2018,May,New Castle
188,244,177,609,09,23,2018,May,New Castle
953,479,578,2010,01,24,2018,May,New Castle
1072,389,490,1951,02,24,2018,May,New Castle
691,293,369,1353,03,24,2018,May,New Castle
626,144,246,1016,04,24,2018,May,New Castle
1200,425,580,2205,05,24,2018,May,New Castle
598,390,417,1405,06,24,2018,May,New Castle
1228,325,434,1987,07,24,2018,May,New Castle
874,424,538,1836,08,24,2018,May,New Castle
506,244,268,1018,09,24,2018,May,New Castle
789,335,458,1582,10,24,2018,May,New Castle
760,252,410,1422,01,25,2018,May,New Castle
573,424,408,1405,02,25,2018,May,New Castle
734,351,494,1579,03,25,2018,May,New Castle
678,381,404,1463,04,25,2018,May,New Castle
607,425,446,1478,05,25,2018,May,New Castle
995,417,495,1907,06,25,2018,May,New Castle
843,496,595,1934,07,25,2018,May,New Castle
429,180,218,827,08,25,2018,May,New Castle
876,428,480,1784,01,26,2018,May,New Castle
919,225,362,1506,02,26,2018,May,New Castle
676,258,328,1262,03,26,2018,May,New Castle
1091,350,465,1906,04,26,2018,May,New Castle
1263,387,602,2252,05,26,2018,May,New Castle
979,354,474,1807,06,26,2018,May,New Castle
1188,415,557,2160,07,26,2018,May,New Castle
302,88,134,524,08,26,2018,May,New Castle
1941,336,603,2880,09,26,2018,May,New Castle
1229,605,643,2477,01,27,2018,May,New Castle
744,351,352,1447,02,27,2018,May,New Castle
794,293,364,1451,03,27,2018,May,New Castle
877,496,578,1951,04,27,2018,May,New Castle
937,505,484,1926,05,27,2018,May,New Castle
947,237,373,1557,06,27,2018,May,New Castle
241,238,189,668,07,27,2018,May,New Castle
937,592,570,2099,08,27,2018,May,New Castle
819,644,476,1939,09,27,2018,May,New Castle
829,687,596,2112,10,27,2018,May,New Castle
900,81,177,1158,01,01,2018,June,New Castle
1571,65,190,1826,02,01,2018,June,New Castle
1117,73,169,1359,03,01,2018,June,New Castle
1576,102,274,1952,04,01,2018,June,New Castle
1225,202,335,1762,05,01,2018,June,New Castle
570,47,111,728,06,01,2018,June,New Castle
655,57,144,856,07,01,2018,June,New Castle
149,61,55,265,08,01,2018,June,New Castle
994,105,162,1261,09,01,2018,June,New Castle
1514,76,216,1806,10,01,2018,June,New Castle
726,66,167,959,11,01,2018,June,New Castle
379,120,173,672,12,01,2018,June,New Castle
849,152,209,1210,13,01,2018,June,New Castle
476,229,242,947,14,01,2018,June,New Castle
1865,115,309,2289,01,02,2018,June,New Castle
635,31,97,763,02,02,2018,June,New Castle
224,54,81,359,03,02,2018,June,New Castle
66,33,22,121,04,02,2018,June,New Castle
1034,107,234,1375,05,02,2018,June,New Castle
839,118,304,1261,06,02,2018,June,New Castle
883,122,228,1233,07,02,2018,June,New Castle
943,59,170,1172,08,02,2018,June,New Castle
519,213,238,970,09,02,2018,June,New Castle
1127,195,438,1760,10,02,2018,June,New Castle
1495,68,235,1798,11,02,2018,June,New Castle
941,51,163,1155,12,02,2018,June,New Castle
378,88,209,675,17,02,2018,June,New Castle
1062,93,231,1386,01,03,2018,June,New Castle
1252,234,317,1803,02,03,2018,June,New Castle
585,56,153,794,03,03,2018,June,New Castle
1348,114,272,1734,04,03,2018,June,New Castle
133,9,33,175,05,03,2018,June,New Castle
1189,109,295,1593,06,03,2018,June,New Castle
1643,167,372,2182,07,03,2018,June,New Castle
1087,188,292,1567,08,03,2018,June,New Castle
1551,172,376,2099,09,03,2018,June,New Castle
271,71,94,436,10,03,2018,June,New Castle
1155,351,405,1911,01,04,2018,June,New Castle
592,649,411,1652,02,04,2018,June,New Castle
1019,372,317,1708,03,04,2018,June,New Castle
544,150,185,879,04,04,2018,June,New Castle
287,40,74,401,05,04,2018,June,New Castle
820,303,373,1496,06,04,2018,June,New Castle
965,332,385,1682,07,04,2018,June,New Castle
942,708,748,2398,08,04,2018,June,New Castle
636,89,208,933,09,04,2018,June,New Castle
222,52,67,341,10,04,2018,June,New Castle
559,588,417,1564,11,04,2018,June,New Castle
632,579,496,1707,12,04,2018,June,New Castle
178,51,78,307,13,04,2018,June,New Castle
196,48,60,304,14,04,2018,June,New Castle
214,242,169,625,15,04,2018,June,New Castle
120,28,48,196,16,04,2018,June,New Castle
1448,307,419,2174,01,05,2018,June,New Castle
742,230,293,1265,02,05,2018,June,New Castle
909,161,242,1312,03,05,2018,June,New Castle
1255,142,331,1728,04,05,2018,June,New Castle
971,151,331,1453,05,05,2018,June,New Castle
1104,164,259,1527,06,05,2018,June,New Castle
712,210,308,1230,07,05,2018,June,New Castle
1378,412,494,2284,08,05,2018,June,New Castle
1085,145,223,1453,09,05,2018,June,New Castle
1151,149,288,1588,10,05,2018,June,New Castle
605,334,367,1306,01,06,2018,June,New Castle
695,603,450,1748,02,06,2018,June,New Castle
174,135,110,419,03,06,2018,June,New Castle
672,303,375,1350,04,06,2018,June,New Castle
1156,336,416,1908,05,06,2018,June,New Castle
648,144,196,988,06,06,2018,June,New Castle
491,408,311,1210,07,06,2018,June,New Castle
1002,593,652,2247,08,06,2018,June,New Castle
1026,585,542,2153,09,06,2018,June,New Castle
638,623,450,1711,10,06,2018,June,New Castle
517,451,362,1330,11,06,2018,June,New Castle
725,594,475,1794,12,06,2018,June,New Castle
832,495,479,1806,01,07,2018,June,New Castle
778,608,520,1906,02,07,2018,June,New Castle
661,471,369,1501,03,07,2018,June,New Castle
1428,582,596,2606,04,07,2018,June,New Castle
466,129,267,862,05,07,2018,June,New Castle
532,290,244,1066,06,07,2018,June,New Castle
827,453,402,1682,07,07,2018,June,New Castle
712,573,459,1744,08,07,2018,June,New Castle
719,433,386,1538,09,07,2018,June,New Castle
1354,430,495,2279,10,07,2018,June,New Castle
441,554,368,1363,01,08,2018,June,New Castle
1117,524,516,2157,02,08,2018,June,New Castle
831,417,390,1638,03,08,2018,June,New Castle
1129,239,320,1688,04,08,2018,June,New Castle
1456,586,619,2661,05,08,2018,June,New Castle
871,612,523,2006,06,08,2018,June,New Castle
678,775,462,1915,07,08,2018,June,New Castle
880,537,456,1873,08,08,2018,June,New Castle
151,143,92,386,09,08,2018,June,New Castle
985,423,484,1892,10,08,2018,June,New Castle
703,571,465,1739,01,09,2018,June,New Castle
755,347,363,1465,02,09,2018,June,New Castle
1037,774,607,2418,03,09,2018,June,New Castle
412,434,257,1103,04,09,2018,June,New Castle
477,286,237,1000,05,09,2018,June,New Castle
590,506,456,1552,06,09,2018,June,New Castle
282,289,197,768,07,09,2018,June,New Castle
672,346,340,1358,08,09,2018,June,New Castle
540,520,407,1467,09,09,2018,June,New Castle
699,397,374,1470,10,09,2018,June,New Castle
814,818,667,2299,11,09,2018,June,New Castle
583,397,360,1340,12,09,2018,June,New Castle
775,493,479,1747,13,09,2018,June,New Castle
792,702,488,1982,01,10,2018,June,New Castle
665,483,383,1531,02,10,2018,June,New Castle
556,483,390,1429,03,10,2018,June,New Castle
1124,485,456,2065,04,10,2018,June,New Castle
581,604,412,1597,05,10,2018,June,New Castle
625,631,418,1674,06,10,2018,June,New Castle
779,650,550,1979,07,10,2018,June,New Castle
1079,242,368,1689,08,10,2018,June,New Castle
574,482,352,1408,09,10,2018,June,New Castle
741,187,271,1199,10,10,2018,June,New Castle
771,495,443,1709,01,11,2018,June,New Castle
1135,447,560,2142,02,11,2018,June,New Castle
614,616,561,1791,03,11,2018,June,New Castle
532,332,335,1199,04,11,2018,June,New Castle
720,529,493,1742,01,12,2018,June,New Castle
561,447,363,1371,02,12,2018,June,New Castle
508,410,382,1300,03,12,2018,June,New Castle
377,606,275,1258,04,12,2018,June,New Castle
653,691,474,1818,05,12,2018,June,New Castle
258,356,185,799,06,12,2018,June,New Castle
552,447,378,1377,07,12,2018,June,New Castle
546,683,479,1708,08,12,2018,June,New Castle
535,461,429,1425,09,12,2018,June,New Castle
665,661,518,1844,10,12,2018,June,New Castle
435,753,407,1595,11,12,2018,June,New Castle
470,549,462,1481,12,12,2018,June,New Castle
372,493,259,1124,13,12,2018,June,New Castle
394,373,295,1062,14,12,2018,June,New Castle
921,411,571,1903,01,13,2018,June,New Castle
658,271,387,1316,02,13,2018,June,New Castle
402,51,82,535,03,13,2018,June,New Castle
864,386,520,1770,04,13,2018,June,New Castle
996,372,561,1929,05,13,2018,June,New Castle
1002,470,612,2084,06,13,2018,June,New Castle
355,130,196,681,07,13,2018,June,New Castle
1324,334,551,2209,08,13,2018,June,New Castle
1038,274,447,1759,09,13,2018,June,New Castle
380,172,239,791,10,13,2018,June,New Castle
455,87,175,717,11,13,2018,June,New Castle
10,2,6,18,12,13,2018,June,New Castle
120,20,37,177,13,13,2018,June,New Castle
1156,536,677,2369,01,15,2018,June,New Castle
1091,595,606,2292,02,15,2018,June,New Castle
1294,478,556,2328,03,15,2018,June,New Castle
627,302,293,1222,04,15,2018,June,New Castle
1634,580,653,2867,05,15,2018,June,New Castle
1093,257,450,1800,06,15,2018,June,New Castle
890,418,438,1746,07,15,2018,June,New Castle
589,321,336,1246,08,15,2018,June,New Castle
317,228,226,771,09,15,2018,June,New Castle
1576,361,563,2500,10,15,2018,June,New Castle
1116,335,450,1901,01,16,2018,June,New Castle
1525,171,353,2049,02,16,2018,June,New Castle
1334,64,189,1587,03,16,2018,June,New Castle
645,150,257,1052,04,16,2018,June,New Castle
1539,130,246,1915,05,16,2018,June,New Castle
1079,137,246,1462,06,16,2018,June,New Castle
928,113,242,1283,07,16,2018,June,New Castle
1437,219,324,1980,08,16,2018,June,New Castle
221,90,89,400,09,16,2018,June,New Castle
1054,271,449,1774,10,16,2018,June,New Castle
845,228,338,1411,01,17,2018,June,New Castle
1970,217,443,2630,02,17,2018,June,New Castle
1325,285,350,1960,03,17,2018,June,New Castle
701,338,334,1373,04,17,2018,June,New Castle
709,276,364,1349,05,17,2018,June,New Castle
95,60,65,220,06,17,2018,June,New Castle
868,256,383,1507,07,17,2018,June,New Castle
662,138,192,992,08,17,2018,June,New Castle
630,262,293,1185,09,17,2018,June,New Castle
922,247,397,1566,10,17,2018,June,New Castle
1170,308,499,1977,11,17,2018,June,New Castle
1433,453,597,2483,01,18,2018,June,New Castle
834,293,403,1530,02,18,2018,June,New Castle
624,234,272,1130,03,18,2018,June,New Castle
1212,370,397,1979,04,18,2018,June,New Castle
895,343,387,1625,05,18,2018,June,New Castle
1192,319,437,1948,06,18,2018,June,New Castle
606,239,335,1180,07,18,2018,June,New Castle
906,225,342,1473,08,18,2018,June,New Castle
749,269,314,1332,09,18,2018,June,New Castle
499,189,209,897,10,18,2018,June,New Castle
885,372,480,1737,01,19,2018,June,New Castle
687,298,388,1373,02,19,2018,June,New Castle
620,429,437,1486,03,19,2018,June,New Castle
869,403,525,1797,04,19,2018,June,New Castle
836,429,526,1791,05,19,2018,June,New Castle
250,91,139,480,06,19,2018,June,New Castle
548,270,302,1120,07,19,2018,June,New Castle
750,410,519,1679,08,19,2018,June,New Castle
720,376,457,1553,09,19,2018,June,New Castle
489,252,310,1051,10,19,2018,June,New Castle
180,87,126,393,11,19,2018,June,New Castle
803,197,301,1301,12,19,2018,June,New Castle
352,280,230,862,01,21,2018,June,New Castle
690,395,442,1527,02,21,2018,June,New Castle
828,575,524,1927,03,21,2018,June,New Castle
844,479,523,1846,04,21,2018,June,New Castle
770,659,532,1961,05,21,2018,June,New Castle
862,569,578,2009,06,21,2018,June,New Castle
53,109,71,233,07,21,2018,June,New Castle
1006,553,625,2184,08,21,2018,June,New Castle
376,273,280,929,09,21,2018,June,New Castle
912,611,593,2116,10,21,2018,June,New Castle
946,519,662,2127,11,21,2018,June,New Castle
563,640,486,1689,01,22,2018,June,New Castle
451,516,431,1398,02,22,2018,June,New Castle
539,619,464,1622,03,22,2018,June,New Castle
501,613,440,1554,04,22,2018,June,New Castle
764,903,648,2315,05,22,2018,June,New Castle
252,276,238,766,06,22,2018,June,New Castle
1080,697,724,2501,07,22,2018,June,New Castle
531,398,376,1305,08,22,2018,June,New Castle
519,480,350,1349,09,22,2018,June,New Castle
520,476,431,1427,10,22,2018,June,New Castle
783,637,589,2009,11,22,2018,June,New Castle
411,428,319,1158,12,22,2018,June,New Castle
281,105,186,572,01,23,2018,June,New Castle
734,524,522,1780,02,23,2018,June,New Castle
547,392,390,1329,03,23,2018,June,New Castle
956,521,494,1971,04,23,2018,June,New Castle
961,326,513,1800,05,23,2018,June,New Castle
695,584,501,1780,06,23,2018,June,New Castle
570,450,428,1448,07,23,2018,June,New Castle
578,460,416,1454,08,23,2018,June,New Castle
188,244,177,609,09,23,2018,June,New Castle
953,479,578,2010,01,24,2018,June,New Castle
1072,389,490,1951,02,24,2018,June,New Castle
691,293,369,1353,03,24,2018,June,New Castle
626,144,246,1016,04,24,2018,June,New Castle
1200,425,580,2205,05,24,2018,June,New Castle
598,390,417,1405,06,24,2018,June,New Castle
1228,325,434,1987,07,24,2018,June,New Castle
874,424,538,1836,08,24,2018,June,New Castle
506,244,268,1018,09,24,2018,June,New Castle
789,335,458,1582,10,24,2018,June,New Castle
760,252,410,1422,01,25,2018,June,New Castle
573,424,408,1405,02,25,2018,June,New Castle
734,351,494,1579,03,25,2018,June,New Castle
678,381,404,1463,04,25,2018,June,New Castle
607,425,446,1478,05,25,2018,June,New Castle
995,417,495,1907,06,25,2018,June,New Castle
843,496,595,1934,07,25,2018,June,New Castle
429,180,218,827,08,25,2018,June,New Castle
876,428,480,1784,01,26,2018,June,New Castle
919,225,362,1506,02,26,2018,June,New Castle
676,258,328,1262,03,26,2018,June,New Castle
1091,350,465,1906,04,26,2018,June,New Castle
1263,387,602,2252,05,26,2018,June,New Castle
979,354,474,1807,06,26,2018,June,New Castle
1188,415,557,2160,07,26,2018,June,New Castle
302,88,134,524,08,26,2018,June,New Castle
1941,336,603,2880,09,26,2018,June,New Castle
1229,605,643,2477,01,27,2018,June,New Castle
744,351,352,1447,02,27,2018,June,New Castle
794,293,364,1451,03,27,2018,June,New Castle
877,496,578,1951,04,27,2018,June,New Castle
937,505,484,1926,05,27,2018,June,New Castle
947,237,373,1557,06,27,2018,June,New Castle
241,238,189,668,07,27,2018,June,New Castle
937,592,570,2099,08,27,2018,June,New Castle
819,644,476,1939,09,27,2018,June,New Castle
829,687,596,2112,10,27,2018,June,New Castle
900,81,177,1158,01,01,2018,July,New Castle
1571,65,190,1826,02,01,2018,July,New Castle
1117,73,169,1359,03,01,2018,July,New Castle
1576,102,274,1952,04,01,2018,July,New Castle
1225,202,335,1762,05,01,2018,July,New Castle
570,47,111,728,06,01,2018,July,New Castle
655,57,144,856,07,01,2018,July,New Castle
149,61,55,265,08,01,2018,July,New Castle
994,105,162,1261,09,01,2018,July,New Castle
1514,76,216,1806,10,01,2018,July,New Castle
726,66,167,959,11,01,2018,July,New Castle
379,120,173,672,12,01,2018,July,New Castle
849,152,209,1210,13,01,2018,July,New Castle
476,229,242,947,14,01,2018,July,New Castle
1865,115,309,2289,01,02,2018,July,New Castle
635,31,97,763,02,02,2018,July,New Castle
224,54,81,359,03,02,2018,July,New Castle
66,33,22,121,04,02,2018,July,New Castle
1034,107,234,1375,05,02,2018,July,New Castle
839,118,304,1261,06,02,2018,July,New Castle
883,122,228,1233,07,02,2018,July,New Castle
943,59,170,1172,08,02,2018,July,New Castle
519,213,238,970,09,02,2018,July,New Castle
1127,195,438,1760,10,02,2018,July,New Castle
1495,68,235,1798,11,02,2018,July,New Castle
941,51,163,1155,12,02,2018,July,New Castle
378,88,209,675,17,02,2018,July,New Castle
1062,93,231,1386,01,03,2018,July,New Castle
1252,234,317,1803,02,03,2018,July,New Castle
585,56,153,794,03,03,2018,July,New Castle
1348,114,272,1734,04,03,2018,July,New Castle
133,9,33,175,05,03,2018,July,New Castle
1189,109,295,1593,06,03,2018,July,New Castle
1643,167,372,2182,07,03,2018,July,New Castle
1087,188,292,1567,08,03,2018,July,New Castle
1551,172,376,2099,09,03,2018,July,New Castle
271,71,94,436,10,03,2018,July,New Castle
1155,351,405,1911,01,04,2018,July,New Castle
592,649,411,1652,02,04,2018,July,New Castle
1019,372,317,1708,03,04,2018,July,New Castle
544,150,185,879,04,04,2018,July,New Castle
287,40,74,401,05,04,2018,July,New Castle
820,303,373,1496,06,04,2018,July,New Castle
965,332,385,1682,07,04,2018,July,New Castle
942,708,748,2398,08,04,2018,July,New Castle
636,89,208,933,09,04,2018,July,New Castle
222,52,67,341,10,04,2018,July,New Castle
559,588,417,1564,11,04,2018,July,New Castle
632,579,496,1707,12,04,2018,July,New Castle
178,51,78,307,13,04,2018,July,New Castle
196,48,60,304,14,04,2018,July,New Castle
214,242,169,625,15,04,2018,July,New Castle
120,28,48,196,16,04,2018,July,New Castle
1448,307,419,2174,01,05,2018,July,New Castle
742,230,293,1265,02,05,2018,July,New Castle
909,161,242,1312,03,05,2018,July,New Castle
1255,142,331,1728,04,05,2018,July,New Castle
971,151,331,1453,05,05,2018,July,New Castle
1104,164,259,1527,06,05,2018,July,New Castle
712,210,308,1230,07,05,2018,July,New Castle
1378,412,494,2284,08,05,2018,July,New Castle
1085,145,223,1453,09,05,2018,July,New Castle
1151,149,288,1588,10,05,2018,July,New Castle
605,334,367,1306,01,06,2018,July,New Castle
695,603,450,1748,02,06,2018,July,New Castle
174,135,110,419,03,06,2018,July,New Castle
672,303,375,1350,04,06,2018,July,New Castle
1156,336,416,1908,05,06,2018,July,New Castle
648,144,196,988,06,06,2018,July,New Castle
491,408,311,1210,07,06,2018,July,New Castle
1002,593,652,2247,08,06,2018,July,New Castle
1026,585,542,2153,09,06,2018,July,New Castle
638,623,450,1711,10,06,2018,July,New Castle
517,451,362,1330,11,06,2018,July,New Castle
725,594,475,1794,12,06,2018,July,New Castle
832,495,479,1806,01,07,2018,July,New Castle
778,608,520,1906,02,07,2018,July,New Castle
661,471,369,1501,03,07,2018,July,New Castle
1428,582,596,2606,04,07,2018,July,New Castle
466,129,267,862,05,07,2018,July,New Castle
532,290,244,1066,06,07,2018,July,New Castle
827,453,402,1682,07,07,2018,July,New Castle
712,573,459,1744,08,07,2018,July,New Castle
719,433,386,1538,09,07,2018,July,New Castle
1354,430,495,2279,10,07,2018,July,New Castle
441,554,368,1363,01,08,2018,July,New Castle
1117,524,516,2157,02,08,2018,July,New Castle
831,417,390,1638,03,08,2018,July,New Castle
1129,239,320,1688,04,08,2018,July,New Castle
1456,586,619,2661,05,08,2018,July,New Castle
871,612,523,2006,06,08,2018,July,New Castle
678,775,462,1915,07,08,2018,July,New Castle
880,537,456,1873,08,08,2018,July,New Castle
151,143,92,386,09,08,2018,July,New Castle
985,423,484,1892,10,08,2018,July,New Castle
703,571,465,1739,01,09,2018,July,New Castle
755,347,363,1465,02,09,2018,July,New Castle
1037,774,607,2418,03,09,2018,July,New Castle
412,434,257,1103,04,09,2018,July,New Castle
477,286,237,1000,05,09,2018,July,New Castle
590,506,456,1552,06,09,2018,July,New Castle
282,289,197,768,07,09,2018,July,New Castle
672,346,340,1358,08,09,2018,July,New Castle
540,520,407,1467,09,09,2018,July,New Castle
699,397,374,1470,10,09,2018,July,New Castle
814,818,667,2299,11,09,2018,July,New Castle
583,397,360,1340,12,09,2018,July,New Castle
775,493,479,1747,13,09,2018,July,New Castle
792,702,488,1982,01,10,2018,July,New Castle
665,483,383,1531,02,10,2018,July,New Castle
556,483,390,1429,03,10,2018,July,New Castle
1124,485,456,2065,04,10,2018,July,New Castle
581,604,412,1597,05,10,2018,July,New Castle
625,631,418,1674,06,10,2018,July,New Castle
779,650,550,1979,07,10,2018,July,New Castle
1079,242,368,1689,08,10,2018,July,New Castle
574,482,352,1408,09,10,2018,July,New Castle
741,187,271,1199,10,10,2018,July,New Castle
771,495,443,1709,01,11,2018,July,New Castle
1135,447,560,2142,02,11,2018,July,New Castle
614,616,561,1791,03,11,2018,July,New Castle
532,332,335,1199,04,11,2018,July,New Castle
720,529,493,1742,01,12,2018,July,New Castle
561,447,363,1371,02,12,2018,July,New Castle
508,410,382,1300,03,12,2018,July,New Castle
377,606,275,1258,04,12,2018,July,New Castle
653,691,474,1818,05,12,2018,July,New Castle
258,356,185,799,06,12,2018,July,New Castle
552,447,378,1377,07,12,2018,July,New Castle
546,683,479,1708,08,12,2018,July,New Castle
535,461,429,1425,09,12,2018,July,New Castle
665,661,518,1844,10,12,2018,July,New Castle
435,753,407,1595,11,12,2018,July,New Castle
470,549,462,1481,12,12,2018,July,New Castle
372,493,259,1124,13,12,2018,July,New Castle
394,373,295,1062,14,12,2018,July,New Castle
921,411,571,1903,01,13,2018,July,New Castle
658,271,387,1316,02,13,2018,July,New Castle
402,51,82,535,03,13,2018,July,New Castle
864,386,520,1770,04,13,2018,July,New Castle
996,372,561,1929,05,13,2018,July,New Castle
1002,470,612,2084,06,13,2018,July,New Castle
355,130,196,681,07,13,2018,July,New Castle
1324,334,551,2209,08,13,2018,July,New Castle
1038,274,447,1759,09,13,2018,July,New Castle
380,172,239,791,10,13,2018,July,New Castle
455,87,175,717,11,13,2018,July,New Castle
10,2,6,18,12,13,2018,July,New Castle
120,20,37,177,13,13,2018,July,New Castle
1156,536,677,2369,01,15,2018,July,New Castle
1091,595,606,2292,02,15,2018,July,New Castle
1294,478,556,2328,03,15,2018,July,New Castle
627,302,293,1222,04,15,2018,July,New Castle
1634,580,653,2867,05,15,2018,July,New Castle
1093,257,450,1800,06,15,2018,July,New Castle
890,418,438,1746,07,15,2018,July,New Castle
589,321,336,1246,08,15,2018,July,New Castle
317,228,226,771,09,15,2018,July,New Castle
1576,361,563,2500,10,15,2018,July,New Castle
1116,335,450,1901,01,16,2018,July,New Castle
1525,171,353,2049,02,16,2018,July,New Castle
1334,64,189,1587,03,16,2018,July,New Castle
645,150,257,1052,04,16,2018,July,New Castle
1539,130,246,1915,05,16,2018,July,New Castle
1079,137,246,1462,06,16,2018,July,New Castle
928,113,242,1283,07,16,2018,July,New Castle
1437,219,324,1980,08,16,2018,July,New Castle
221,90,89,400,09,16,2018,July,New Castle
1054,271,449,1774,10,16,2018,July,New Castle
845,228,338,1411,01,17,2018,July,New Castle
1970,217,443,2630,02,17,2018,July,New Castle
1325,285,350,1960,03,17,2018,July,New Castle
701,338,334,1373,04,17,2018,July,New Castle
709,276,364,1349,05,17,2018,July,New Castle
95,60,65,220,06,17,2018,July,New Castle
868,256,383,1507,07,17,2018,July,New Castle
662,138,192,992,08,17,2018,July,New Castle
630,262,293,1185,09,17,2018,July,New Castle
922,247,397,1566,10,17,2018,July,New Castle
1170,308,499,1977,11,17,2018,July,New Castle
1433,453,597,2483,01,18,2018,July,New Castle
834,293,403,1530,02,18,2018,July,New Castle
624,234,272,1130,03,18,2018,July,New Castle
1212,370,397,1979,04,18,2018,July,New Castle
895,343,387,1625,05,18,2018,July,New Castle
1192,319,437,1948,06,18,2018,July,New Castle
606,239,335,1180,07,18,2018,July,New Castle
906,225,342,1473,08,18,2018,July,New Castle
749,269,314,1332,09,18,2018,July,New Castle
499,189,209,897,10,18,2018,July,New Castle
885,372,480,1737,01,19,2018,July,New Castle
687,298,388,1373,02,19,2018,July,New Castle
620,429,437,1486,03,19,2018,July,New Castle
869,403,525,1797,04,19,2018,July,New Castle
836,429,526,1791,05,19,2018,July,New Castle
250,91,139,480,06,19,2018,July,New Castle
548,270,302,1120,07,19,2018,July,New Castle
750,410,519,1679,08,19,2018,July,New Castle
720,376,457,1553,09,19,2018,July,New Castle
489,252,310,1051,10,19,2018,July,New Castle
180,87,126,393,11,19,2018,July,New Castle
803,197,301,1301,12,19,2018,July,New Castle
352,280,230,862,01,21,2018,July,New Castle
690,395,442,1527,02,21,2018,July,New Castle
828,575,524,1927,03,21,2018,July,New Castle
844,479,523,1846,04,21,2018,July,New Castle
770,659,532,1961,05,21,2018,July,New Castle
862,569,578,2009,06,21,2018,July,New Castle
53,109,71,233,07,21,2018,July,New Castle
1006,553,625,2184,08,21,2018,July,New Castle
376,273,280,929,09,21,2018,July,New Castle
912,611,593,2116,10,21,2018,July,New Castle
946,519,662,2127,11,21,2018,July,New Castle
563,640,486,1689,01,22,2018,July,New Castle
451,516,431,1398,02,22,2018,July,New Castle
539,619,464,1622,03,22,2018,July,New Castle
501,613,440,1554,04,22,2018,July,New Castle
764,903,648,2315,05,22,2018,July,New Castle
252,276,238,766,06,22,2018,July,New Castle
1080,697,724,2501,07,22,2018,July,New Castle
531,398,376,1305,08,22,2018,July,New Castle
519,480,350,1349,09,22,2018,July,New Castle
520,476,431,1427,10,22,2018,July,New Castle
783,637,589,2009,11,22,2018,July,New Castle
411,428,319,1158,12,22,2018,July,New Castle
281,105,186,572,01,23,2018,July,New Castle
734,524,522,1780,02,23,2018,July,New Castle
547,392,390,1329,03,23,2018,July,New Castle
956,521,494,1971,04,23,2018,July,New Castle
961,326,513,1800,05,23,2018,July,New Castle
695,584,501,1780,06,23,2018,July,New Castle
570,450,428,1448,07,23,2018,July,New Castle
578,460,416,1454,08,23,2018,July,New Castle
188,244,177,609,09,23,2018,July,New Castle
953,479,578,2010,01,24,2018,July,New Castle
1072,389,490,1951,02,24,2018,July,New Castle
691,293,369,1353,03,24,2018,July,New Castle
626,144,246,1016,04,24,2018,July,New Castle
1200,425,580,2205,05,24,2018,July,New Castle
598,390,417,1405,06,24,2018,July,New Castle
1228,325,434,1987,07,24,2018,July,New Castle
874,424,538,1836,08,24,2018,July,New Castle
506,244,268,1018,09,24,2018,July,New Castle
789,335,458,1582,10,24,2018,July,New Castle
760,252,410,1422,01,25,2018,July,New Castle
573,424,408,1405,02,25,2018,July,New Castle
734,351,494,1579,03,25,2018,July,New Castle
678,381,404,1463,04,25,2018,July,New Castle
607,425,446,1478,05,25,2018,July,New Castle
995,417,495,1907,06,25,2018,July,New Castle
843,496,595,1934,07,25,2018,July,New Castle
429,180,218,827,08,25,2018,July,New Castle
876,428,480,1784,01,26,2018,July,New Castle
919,225,362,1506,02,26,2018,July,New Castle
676,258,328,1262,03,26,2018,July,New Castle
1091,350,465,1906,04,26,2018,July,New Castle
1263,387,602,2252,05,26,2018,July,New Castle
979,354,474,1807,06,26,2018,July,New Castle
1188,415,557,2160,07,26,2018,July,New Castle
302,88,134,524,08,26,2018,July,New Castle
1941,336,603,2880,09,26,2018,July,New Castle
1229,605,643,2477,01,27,2018,July,New Castle
744,351,352,1447,02,27,2018,July,New Castle
794,293,364,1451,03,27,2018,July,New Castle
877,496,578,1951,04,27,2018,July,New Castle
937,505,484,1926,05,27,2018,July,New Castle
947,237,373,1557,06,27,2018,July,New Castle
241,238,189,668,07,27,2018,July,New Castle
937,592,570,2099,08,27,2018,July,New Castle
819,644,476,1939,09,27,2018,July,New Castle
829,687,596,2112,10,27,2018,July,New Castle
900,81,177,1158,01,01,2018,August,New Castle
1571,65,190,1826,02,01,2018,August,New Castle
1117,73,169,1359,03,01,2018,August,New Castle
1576,102,274,1952,04,01,2018,August,New Castle
1225,202,335,1762,05,01,2018,August,New Castle
570,47,111,728,06,01,2018,August,New Castle
655,57,144,856,07,01,2018,August,New Castle
149,61,55,265,08,01,2018,August,New Castle
994,105,162,1261,09,01,2018,August,New Castle
1514,76,216,1806,10,01,2018,August,New Castle
726,66,167,959,11,01,2018,August,New Castle
379,120,173,672,12,01,2018,August,New Castle
849,152,209,1210,13,01,2018,August,New Castle
476,229,242,947,14,01,2018,August,New Castle
1865,115,309,2289,01,02,2018,August,New Castle
635,31,97,763,02,02,2018,August,New Castle
224,54,81,359,03,02,2018,August,New Castle
66,33,22,121,04,02,2018,August,New Castle
1034,107,234,1375,05,02,2018,August,New Castle
839,118,304,1261,06,02,2018,August,New Castle
883,122,228,1233,07,02,2018,August,New Castle
943,59,170,1172,08,02,2018,August,New Castle
519,213,238,970,09,02,2018,August,New Castle
1127,195,438,1760,10,02,2018,August,New Castle
1495,68,235,1798,11,02,2018,August,New Castle
941,51,163,1155,12,02,2018,August,New Castle
378,88,209,675,17,02,2018,August,New Castle
1062,93,231,1386,01,03,2018,August,New Castle
1252,234,317,1803,02,03,2018,August,New Castle
585,56,153,794,03,03,2018,August,New Castle
1348,114,272,1734,04,03,2018,August,New Castle
133,9,33,175,05,03,2018,August,New Castle
1189,109,295,1593,06,03,2018,August,New Castle
1643,167,372,2182,07,03,2018,August,New Castle
1087,188,292,1567,08,03,2018,August,New Castle
1551,172,376,2099,09,03,2018,August,New Castle
271,71,94,436,10,03,2018,August,New Castle
1155,351,405,1911,01,04,2018,August,New Castle
592,649,411,1652,02,04,2018,August,New Castle
1019,372,317,1708,03,04,2018,August,New Castle
544,150,185,879,04,04,2018,August,New Castle
287,40,74,401,05,04,2018,August,New Castle
820,303,373,1496,06,04,2018,August,New Castle
965,332,385,1682,07,04,2018,August,New Castle
942,708,748,2398,08,04,2018,August,New Castle
636,89,208,933,09,04,2018,August,New Castle
222,52,67,341,10,04,2018,August,New Castle
559,588,417,1564,11,04,2018,August,New Castle
632,579,496,1707,12,04,2018,August,New Castle
178,51,78,307,13,04,2018,August,New Castle
196,48,60,304,14,04,2018,August,New Castle
214,242,169,625,15,04,2018,August,New Castle
120,28,48,196,16,04,2018,August,New Castle
1448,307,419,2174,01,05,2018,August,New Castle
742,230,293,1265,02,05,2018,August,New Castle
909,161,242,1312,03,05,2018,August,New Castle
1255,142,331,1728,04,05,2018,August,New Castle
971,151,331,1453,05,05,2018,August,New Castle
1104,164,259,1527,06,05,2018,August,New Castle
712,210,308,1230,07,05,2018,August,New Castle
1378,412,494,2284,08,05,2018,August,New Castle
1085,145,223,1453,09,05,2018,August,New Castle
1151,149,288,1588,10,05,2018,August,New Castle
605,334,367,1306,01,06,2018,August,New Castle
695,603,450,1748,02,06,2018,August,New Castle
174,135,110,419,03,06,2018,August,New Castle
672,303,375,1350,04,06,2018,August,New Castle
1156,336,416,1908,05,06,2018,August,New Castle
648,144,196,988,06,06,2018,August,New Castle
491,408,311,1210,07,06,2018,August,New Castle
1002,593,652,2247,08,06,2018,August,New Castle
1026,585,542,2153,09,06,2018,August,New Castle
638,623,450,1711,10,06,2018,August,New Castle
517,451,362,1330,11,06,2018,August,New Castle
725,594,475,1794,12,06,2018,August,New Castle
832,495,479,1806,01,07,2018,August,New Castle
778,608,520,1906,02,07,2018,August,New Castle
661,471,369,1501,03,07,2018,August,New Castle
1428,582,596,2606,04,07,2018,August,New Castle
466,129,267,862,05,07,2018,August,New Castle
532,290,244,1066,06,07,2018,August,New Castle
827,453,402,1682,07,07,2018,August,New Castle
712,573,459,1744,08,07,2018,August,New Castle
719,433,386,1538,09,07,2018,August,New Castle
1354,430,495,2279,10,07,2018,August,New Castle
441,554,368,1363,01,08,2018,August,New Castle
1117,524,516,2157,02,08,2018,August,New Castle
831,417,390,1638,03,08,2018,August,New Castle
1129,239,320,1688,04,08,2018,August,New Castle
1456,586,619,2661,05,08,2018,August,New Castle
871,612,523,2006,06,08,2018,August,New Castle
678,775,462,1915,07,08,2018,August,New Castle
880,537,456,1873,08,08,2018,August,New Castle
151,143,92,386,09,08,2018,August,New Castle
985,423,484,1892,10,08,2018,August,New Castle
703,571,465,1739,01,09,2018,August,New Castle
755,347,363,1465,02,09,2018,August,New Castle
1037,774,607,2418,03,09,2018,August,New Castle
412,434,257,1103,04,09,2018,August,New Castle
477,286,237,1000,05,09,2018,August,New Castle
590,506,456,1552,06,09,2018,August,New Castle
282,289,197,768,07,09,2018,August,New Castle
672,346,340,1358,08,09,2018,August,New Castle
540,520,407,1467,09,09,2018,August,New Castle
699,397,374,1470,10,09,2018,August,New Castle
814,818,667,2299,11,09,2018,August,New Castle
583,397,360,1340,12,09,2018,August,New Castle
775,493,479,1747,13,09,2018,August,New Castle
792,702,488,1982,01,10,2018,August,New Castle
665,483,383,1531,02,10,2018,August,New Castle
556,483,390,1429,03,10,2018,August,New Castle
1124,485,456,2065,04,10,2018,August,New Castle
581,604,412,1597,05,10,2018,August,New Castle
625,631,418,1674,06,10,2018,August,New Castle
779,650,550,1979,07,10,2018,August,New Castle
1079,242,368,1689,08,10,2018,August,New Castle
574,482,352,1408,09,10,2018,August,New Castle
741,187,271,1199,10,10,2018,August,New Castle
771,495,443,1709,01,11,2018,August,New Castle
1135,447,560,2142,02,11,2018,August,New Castle
614,616,561,1791,03,11,2018,August,New Castle
532,332,335,1199,04,11,2018,August,New Castle
720,529,493,1742,01,12,2018,August,New Castle
561,447,363,1371,02,12,2018,August,New Castle
508,410,382,1300,03,12,2018,August,New Castle
377,606,275,1258,04,12,2018,August,New Castle
653,691,474,1818,05,12,2018,August,New Castle
258,356,185,799,06,12,2018,August,New Castle
552,447,378,1377,07,12,2018,August,New Castle
546,683,479,1708,08,12,2018,August,New Castle
535,461,429,1425,09,12,2018,August,New Castle
665,661,518,1844,10,12,2018,August,New Castle
435,753,407,1595,11,12,2018,August,New Castle
470,549,462,1481,12,12,2018,August,New Castle
372,493,259,1124,13,12,2018,August,New Castle
394,373,295,1062,14,12,2018,August,New Castle
921,411,571,1903,01,13,2018,August,New Castle
658,271,387,1316,02,13,2018,August,New Castle
402,51,82,535,03,13,2018,August,New Castle
864,386,520,1770,04,13,2018,August,New Castle
996,372,561,1929,05,13,2018,August,New Castle
1002,470,612,2084,06,13,2018,August,New Castle
355,130,196,681,07,13,2018,August,New Castle
1324,334,551,2209,08,13,2018,August,New Castle
1038,274,447,1759,09,13,2018,August,New Castle
380,172,239,791,10,13,2018,August,New Castle
455,87,175,717,11,13,2018,August,New Castle
10,2,6,18,12,13,2018,August,New Castle
120,20,37,177,13,13,2018,August,New Castle
1156,536,677,2369,01,15,2018,August,New Castle
1091,595,606,2292,02,15,2018,August,New Castle
1294,478,556,2328,03,15,2018,August,New Castle
627,302,293,1222,04,15,2018,August,New Castle
1634,580,653,2867,05,15,2018,August,New Castle
1093,257,450,1800,06,15,2018,August,New Castle
890,418,438,1746,07,15,2018,August,New Castle
589,321,336,1246,08,15,2018,August,New Castle
317,228,226,771,09,15,2018,August,New Castle
1576,361,563,2500,10,15,2018,August,New Castle
1116,335,450,1901,01,16,2018,August,New Castle
1525,171,353,2049,02,16,2018,August,New Castle
1334,64,189,1587,03,16,2018,August,New Castle
645,150,257,1052,04,16,2018,August,New Castle
1539,130,246,1915,05,16,2018,August,New Castle
1079,137,246,1462,06,16,2018,August,New Castle
928,113,242,1283,07,16,2018,August,New Castle
1437,219,324,1980,08,16,2018,August,New Castle
221,90,89,400,09,16,2018,August,New Castle
1054,271,449,1774,10,16,2018,August,New Castle
845,228,338,1411,01,17,2018,August,New Castle
1970,217,443,2630,02,17,2018,August,New Castle
1325,285,350,1960,03,17,2018,August,New Castle
701,338,334,1373,04,17,2018,August,New Castle
709,276,364,1349,05,17,2018,August,New Castle
95,60,65,220,06,17,2018,August,New Castle
868,256,383,1507,07,17,2018,August,New Castle
662,138,192,992,08,17,2018,August,New Castle
630,262,293,1185,09,17,2018,August,New Castle
922,247,397,1566,10,17,2018,August,New Castle
1170,308,499,1977,11,17,2018,August,New Castle
1433,453,597,2483,01,18,2018,August,New Castle
834,293,403,1530,02,18,2018,August,New Castle
624,234,272,1130,03,18,2018,August,New Castle
1212,370,397,1979,04,18,2018,August,New Castle
895,343,387,1625,05,18,2018,August,New Castle
1192,319,437,1948,06,18,2018,August,New Castle
606,239,335,1180,07,18,2018,August,New Castle
906,225,342,1473,08,18,2018,August,New Castle
749,269,314,1332,09,18,2018,August,New Castle
499,189,209,897,10,18,2018,August,New Castle
885,372,480,1737,01,19,2018,August,New Castle
687,298,388,1373,02,19,2018,August,New Castle
620,429,437,1486,03,19,2018,August,New Castle
869,403,525,1797,04,19,2018,August,New Castle
836,429,526,1791,05,19,2018,August,New Castle
250,91,139,480,06,19,2018,August,New Castle
548,270,302,1120,07,19,2018,August,New Castle
750,410,519,1679,08,19,2018,August,New Castle
720,376,457,1553,09,19,2018,August,New Castle
489,252,310,1051,10,19,2018,August,New Castle
180,87,126,393,11,19,2018,August,New Castle
803,197,301,1301,12,19,2018,August,New Castle
352,280,230,862,01,21,2018,August,New Castle
690,395,442,1527,02,21,2018,August,New Castle
828,575,524,1927,03,21,2018,August,New Castle
844,479,523,1846,04,21,2018,August,New Castle
770,659,532,1961,05,21,2018,August,New Castle
862,569,578,2009,06,21,2018,August,New Castle
53,109,71,233,07,21,2018,August,New Castle
1006,553,625,2184,08,21,2018,August,New Castle
376,273,280,929,09,21,2018,August,New Castle
912,611,593,2116,10,21,2018,August,New Castle
946,519,662,2127,11,21,2018,August,New Castle
563,640,486,1689,01,22,2018,August,New Castle
451,516,431,1398,02,22,2018,August,New Castle
539,619,464,1622,03,22,2018,August,New Castle
501,613,440,1554,04,22,2018,August,New Castle
764,903,648,2315,05,22,2018,August,New Castle
252,276,238,766,06,22,2018,August,New Castle
1080,697,724,2501,07,22,2018,August,New Castle
531,398,376,1305,08,22,2018,August,New Castle
519,480,350,1349,09,22,2018,August,New Castle
520,476,431,1427,10,22,2018,August,New Castle
783,637,589,2009,11,22,2018,August,New Castle
411,428,319,1158,12,22,2018,August,New Castle
281,105,186,572,01,23,2018,August,New Castle
734,524,522,1780,02,23,2018,August,New Castle
547,392,390,1329,03,23,2018,August,New Castle
956,521,494,1971,04,23,2018,August,New Castle
961,326,513,1800,05,23,2018,August,New Castle
695,584,501,1780,06,23,2018,August,New Castle
570,450,428,1448,07,23,2018,August,New Castle
578,460,416,1454,08,23,2018,August,New Castle
188,244,177,609,09,23,2018,August,New Castle
953,479,578,2010,01,24,2018,August,New Castle
1072,389,490,1951,02,24,2018,August,New Castle
691,293,369,1353,03,24,2018,August,New Castle
626,144,246,1016,04,24,2018,August,New Castle
1200,425,580,2205,05,24,2018,August,New Castle
598,390,417,1405,06,24,2018,August,New Castle
1228,325,434,1987,07,24,2018,August,New Castle
874,424,538,1836,08,24,2018,August,New Castle
506,244,268,1018,09,24,2018,August,New Castle
789,335,458,1582,10,24,2018,August,New Castle
760,252,410,1422,01,25,2018,August,New Castle
573,424,408,1405,02,25,2018,August,New Castle
734,351,494,1579,03,25,2018,August,New Castle
678,381,404,1463,04,25,2018,August,New Castle
607,425,446,1478,05,25,2018,August,New Castle
995,417,495,1907,06,25,2018,August,New Castle
843,496,595,1934,07,25,2018,August,New Castle
429,180,218,827,08,25,2018,August,New Castle
876,428,480,1784,01,26,2018,August,New Castle
919,225,362,1506,02,26,2018,August,New Castle
676,258,328,1262,03,26,2018,August,New Castle
1091,350,465,1906,04,26,2018,August,New Castle
1263,387,602,2252,05,26,2018,August,New Castle
979,354,474,1807,06,26,2018,August,New Castle
1188,415,557,2160,07,26,2018,August,New Castle
302,88,134,524,08,26,2018,August,New Castle
1941,336,603,2880,09,26,2018,August,New Castle
1229,605,643,2477,01,27,2018,August,New Castle
744,351,352,1447,02,27,2018,August,New Castle
794,293,364,1451,03,27,2018,August,New Castle
877,496,578,1951,04,27,2018,August,New Castle
937,505,484,1926,05,27,2018,August,New Castle
947,237,373,1557,06,27,2018,August,New Castle
241,238,189,668,07,27,2018,August,New Castle
937,592,570,2099,08,27,2018,August,New Castle
819,644,476,1939,09,27,2018,August,New Castle
829,687,596,2112,10,27,2018,August,New Castle
900,81,177,1158,01,01,2018,September,New Castle
1571,65,190,1826,02,01,2018,September,New Castle
1117,73,169,1359,03,01,2018,September,New Castle
1576,102,274,1952,04,01,2018,September,New Castle
1225,202,335,1762,05,01,2018,September,New Castle
570,47,111,728,06,01,2018,September,New Castle
655,57,144,856,07,01,2018,September,New Castle
149,61,55,265,08,01,2018,September,New Castle
994,105,162,1261,09,01,2018,September,New Castle
1514,76,216,1806,10,01,2018,September,New Castle
726,66,167,959,11,01,2018,September,New Castle
379,120,173,672,12,01,2018,September,New Castle
849,152,209,1210,13,01,2018,September,New Castle
476,229,242,947,14,01,2018,September,New Castle
1865,115,309,2289,01,02,2018,September,New Castle
635,31,97,763,02,02,2018,September,New Castle
224,54,81,359,03,02,2018,September,New Castle
66,33,22,121,04,02,2018,September,New Castle
1034,107,234,1375,05,02,2018,September,New Castle
839,118,304,1261,06,02,2018,September,New Castle
883,122,228,1233,07,02,2018,September,New Castle
943,59,170,1172,08,02,2018,September,New Castle
519,213,238,970,09,02,2018,September,New Castle
1127,195,438,1760,10,02,2018,September,New Castle
1495,68,235,1798,11,02,2018,September,New Castle
941,51,163,1155,12,02,2018,September,New Castle
378,88,209,675,17,02,2018,September,New Castle
1062,93,231,1386,01,03,2018,September,New Castle
1252,234,317,1803,02,03,2018,September,New Castle
585,56,153,794,03,03,2018,September,New Castle
1348,114,272,1734,04,03,2018,September,New Castle
133,9,33,175,05,03,2018,September,New Castle
1189,109,295,1593,06,03,2018,September,New Castle
1643,167,372,2182,07,03,2018,September,New Castle
1087,188,292,1567,08,03,2018,September,New Castle
1551,172,376,2099,09,03,2018,September,New Castle
271,71,94,436,10,03,2018,September,New Castle
1155,351,405,1911,01,04,2018,September,New Castle
592,649,411,1652,02,04,2018,September,New Castle
1019,372,317,1708,03,04,2018,September,New Castle
544,150,185,879,04,04,2018,September,New Castle
287,40,74,401,05,04,2018,September,New Castle
820,303,373,1496,06,04,2018,September,New Castle
965,332,385,1682,07,04,2018,September,New Castle
942,708,748,2398,08,04,2018,September,New Castle
636,89,208,933,09,04,2018,September,New Castle
222,52,67,341,10,04,2018,September,New Castle
559,588,417,1564,11,04,2018,September,New Castle
632,579,496,1707,12,04,2018,September,New Castle
178,51,78,307,13,04,2018,September,New Castle
196,48,60,304,14,04,2018,September,New Castle
214,242,169,625,15,04,2018,September,New Castle
120,28,48,196,16,04,2018,September,New Castle
1448,307,419,2174,01,05,2018,September,New Castle
742,230,293,1265,02,05,2018,September,New Castle
909,161,242,1312,03,05,2018,September,New Castle
1255,142,331,1728,04,05,2018,September,New Castle
971,151,331,1453,05,05,2018,September,New Castle
1104,164,259,1527,06,05,2018,September,New Castle
712,210,308,1230,07,05,2018,September,New Castle
1378,412,494,2284,08,05,2018,September,New Castle
1085,145,223,1453,09,05,2018,September,New Castle
1151,149,288,1588,10,05,2018,September,New Castle
605,334,367,1306,01,06,2018,September,New Castle
695,603,450,1748,02,06,2018,September,New Castle
174,135,110,419,03,06,2018,September,New Castle
672,303,375,1350,04,06,2018,September,New Castle
1156,336,416,1908,05,06,2018,September,New Castle
648,144,196,988,06,06,2018,September,New Castle
491,408,311,1210,07,06,2018,September,New Castle
1002,593,652,2247,08,06,2018,September,New Castle
1026,585,542,2153,09,06,2018,September,New Castle
638,623,450,1711,10,06,2018,September,New Castle
517,451,362,1330,11,06,2018,September,New Castle
725,594,475,1794,12,06,2018,September,New Castle
832,495,479,1806,01,07,2018,September,New Castle
778,608,520,1906,02,07,2018,September,New Castle
661,471,369,1501,03,07,2018,September,New Castle
1428,582,596,2606,04,07,2018,September,New Castle
466,129,267,862,05,07,2018,September,New Castle
532,290,244,1066,06,07,2018,September,New Castle
827,453,402,1682,07,07,2018,September,New Castle
712,573,459,1744,08,07,2018,September,New Castle
719,433,386,1538,09,07,2018,September,New Castle
1354,430,495,2279,10,07,2018,September,New Castle
441,554,368,1363,01,08,2018,September,New Castle
1117,524,516,2157,02,08,2018,September,New Castle
831,417,390,1638,03,08,2018,September,New Castle
1129,239,320,1688,04,08,2018,September,New Castle
1456,586,619,2661,05,08,2018,September,New Castle
871,612,523,2006,06,08,2018,September,New Castle
678,775,462,1915,07,08,2018,September,New Castle
880,537,456,1873,08,08,2018,September,New Castle
151,143,92,386,09,08,2018,September,New Castle
985,423,484,1892,10,08,2018,September,New Castle
703,571,465,1739,01,09,2018,September,New Castle
755,347,363,1465,02,09,2018,September,New Castle
1037,774,607,2418,03,09,2018,September,New Castle
412,434,257,1103,04,09,2018,September,New Castle
477,286,237,1000,05,09,2018,September,New Castle
590,506,456,1552,06,09,2018,September,New Castle
282,289,197,768,07,09,2018,September,New Castle
672,346,340,1358,08,09,2018,September,New Castle
540,520,407,1467,09,09,2018,September,New Castle
699,397,374,1470,10,09,2018,September,New Castle
814,818,667,2299,11,09,2018,September,New Castle
583,397,360,1340,12,09,2018,September,New Castle
775,493,479,1747,13,09,2018,September,New Castle
792,702,488,1982,01,10,2018,September,New Castle
665,483,383,1531,02,10,2018,September,New Castle
556,483,390,1429,03,10,2018,September,New Castle
1124,485,456,2065,04,10,2018,September,New Castle
581,604,412,1597,05,10,2018,September,New Castle
625,631,418,1674,06,10,2018,September,New Castle
779,650,550,1979,07,10,2018,September,New Castle
1079,242,368,1689,08,10,2018,September,New Castle
574,482,352,1408,09,10,2018,September,New Castle
741,187,271,1199,10,10,2018,September,New Castle
771,495,443,1709,01,11,2018,September,New Castle
1135,447,560,2142,02,11,2018,September,New Castle
614,616,561,1791,03,11,2018,September,New Castle
532,332,335,1199,04,11,2018,September,New Castle
720,529,493,1742,01,12,2018,September,New Castle
561,447,363,1371,02,12,2018,September,New Castle
508,410,382,1300,03,12,2018,September,New Castle
377,606,275,1258,04,12,2018,September,New Castle
653,691,474,1818,05,12,2018,September,New Castle
258,356,185,799,06,12,2018,September,New Castle
552,447,378,1377,07,12,2018,September,New Castle
546,683,479,1708,08,12,2018,September,New Castle
535,461,429,1425,09,12,2018,September,New Castle
665,661,518,1844,10,12,2018,September,New Castle
435,753,407,1595,11,12,2018,September,New Castle
470,549,462,1481,12,12,2018,September,New Castle
372,493,259,1124,13,12,2018,September,New Castle
394,373,295,1062,14,12,2018,September,New Castle
921,411,571,1903,01,13,2018,September,New Castle
658,271,387,1316,02,13,2018,September,New Castle
402,51,82,535,03,13,2018,September,New Castle
864,386,520,1770,04,13,2018,September,New Castle
996,372,561,1929,05,13,2018,September,New Castle
1002,470,612,2084,06,13,2018,September,New Castle
355,130,196,681,07,13,2018,September,New Castle
1324,334,551,2209,08,13,2018,September,New Castle
1038,274,447,1759,09,13,2018,September,New Castle
380,172,239,791,10,13,2018,September,New Castle
455,87,175,717,11,13,2018,September,New Castle
10,2,6,18,12,13,2018,September,New Castle
120,20,37,177,13,13,2018,September,New Castle
1156,536,677,2369,01,15,2018,September,New Castle
1091,595,606,2292,02,15,2018,September,New Castle
1294,478,556,2328,03,15,2018,September,New Castle
627,302,293,1222,04,15,2018,September,New Castle
1634,580,653,2867,05,15,2018,September,New Castle
1093,257,450,1800,06,15,2018,September,New Castle
890,418,438,1746,07,15,2018,September,New Castle
589,321,336,1246,08,15,2018,September,New Castle
317,228,226,771,09,15,2018,September,New Castle
1576,361,563,2500,10,15,2018,September,New Castle
1116,335,450,1901,01,16,2018,September,New Castle
1525,171,353,2049,02,16,2018,September,New Castle
1334,64,189,1587,03,16,2018,September,New Castle
645,150,257,1052,04,16,2018,September,New Castle
1539,130,246,1915,05,16,2018,September,New Castle
1079,137,246,1462,06,16,2018,September,New Castle
928,113,242,1283,07,16,2018,September,New Castle
1437,219,324,1980,08,16,2018,September,New Castle
221,90,89,400,09,16,2018,September,New Castle
1054,271,449,1774,10,16,2018,September,New Castle
845,228,338,1411,01,17,2018,September,New Castle
1970,217,443,2630,02,17,2018,September,New Castle
1325,285,350,1960,03,17,2018,September,New Castle
701,338,334,1373,04,17,2018,September,New Castle
709,276,364,1349,05,17,2018,September,New Castle
95,60,65,220,06,17,2018,September,New Castle
868,256,383,1507,07,17,2018,September,New Castle
662,138,192,992,08,17,2018,September,New Castle
630,262,293,1185,09,17,2018,September,New Castle
922,247,397,1566,10,17,2018,September,New Castle
1170,308,499,1977,11,17,2018,September,New Castle
1433,453,597,2483,01,18,2018,September,New Castle
834,293,403,1530,02,18,2018,September,New Castle
624,234,272,1130,03,18,2018,September,New Castle
1212,370,397,1979,04,18,2018,September,New Castle
895,343,387,1625,05,18,2018,September,New Castle
1192,319,437,1948,06,18,2018,September,New Castle
606,239,335,1180,07,18,2018,September,New Castle
906,225,342,1473,08,18,2018,September,New Castle
749,269,314,1332,09,18,2018,September,New Castle
499,189,209,897,10,18,2018,September,New Castle
885,372,480,1737,01,19,2018,September,New Castle
687,298,388,1373,02,19,2018,September,New Castle
620,429,437,1486,03,19,2018,September,New Castle
869,403,525,1797,04,19,2018,September,New Castle
836,429,526,1791,05,19,2018,September,New Castle
250,91,139,480,06,19,2018,September,New Castle
548,270,302,1120,07,19,2018,September,New Castle
750,410,519,1679,08,19,2018,September,New Castle
720,376,457,1553,09,19,2018,September,New Castle
489,252,310,1051,10,19,2018,September,New Castle
180,87,126,393,11,19,2018,September,New Castle
803,197,301,1301,12,19,2018,September,New Castle
352,280,230,862,01,21,2018,September,New Castle
690,395,442,1527,02,21,2018,September,New Castle
828,575,524,1927,03,21,2018,September,New Castle
844,479,523,1846,04,21,2018,September,New Castle
770,659,532,1961,05,21,2018,September,New Castle
862,569,578,2009,06,21,2018,September,New Castle
53,109,71,233,07,21,2018,September,New Castle
1006,553,625,2184,08,21,2018,September,New Castle
376,273,280,929,09,21,2018,September,New Castle
912,611,593,2116,10,21,2018,September,New Castle
946,519,662,2127,11,21,2018,September,New Castle
563,640,486,1689,01,22,2018,September,New Castle
451,516,431,1398,02,22,2018,September,New Castle
539,619,464,1622,03,22,2018,September,New Castle
501,613,440,1554,04,22,2018,September,New Castle
764,903,648,2315,05,22,2018,September,New Castle
252,276,238,766,06,22,2018,September,New Castle
1080,697,724,2501,07,22,2018,September,New Castle
531,398,376,1305,08,22,2018,September,New Castle
519,480,350,1349,09,22,2018,September,New Castle
520,476,431,1427,10,22,2018,September,New Castle
783,637,589,2009,11,22,2018,September,New Castle
411,428,319,1158,12,22,2018,September,New Castle
281,105,186,572,01,23,2018,September,New Castle
734,524,522,1780,02,23,2018,September,New Castle
547,392,390,1329,03,23,2018,September,New Castle
956,521,494,1971,04,23,2018,September,New Castle
961,326,513,1800,05,23,2018,September,New Castle
695,584,501,1780,06,23,2018,September,New Castle
570,450,428,1448,07,23,2018,September,New Castle
578,460,416,1454,08,23,2018,September,New Castle
188,244,177,609,09,23,2018,September,New Castle
953,479,578,2010,01,24,2018,September,New Castle
1072,389,490,1951,02,24,2018,September,New Castle
691,293,369,1353,03,24,2018,September,New Castle
626,144,246,1016,04,24,2018,September,New Castle
1200,425,580,2205,05,24,2018,September,New Castle
598,390,417,1405,06,24,2018,September,New Castle
1228,325,434,1987,07,24,2018,September,New Castle
874,424,538,1836,08,24,2018,September,New Castle
506,244,268,1018,09,24,2018,September,New Castle
789,335,458,1582,10,24,2018,September,New Castle
760,252,410,1422,01,25,2018,September,New Castle
573,424,408,1405,02,25,2018,September,New Castle
734,351,494,1579,03,25,2018,September,New Castle
678,381,404,1463,04,25,2018,September,New Castle
607,425,446,1478,05,25,2018,September,New Castle
995,417,495,1907,06,25,2018,September,New Castle
843,496,595,1934,07,25,2018,September,New Castle
429,180,218,827,08,25,2018,September,New Castle
876,428,480,1784,01,26,2018,September,New Castle
919,225,362,1506,02,26,2018,September,New Castle
676,258,328,1262,03,26,2018,September,New Castle
1091,350,465,1906,04,26,2018,September,New Castle
1263,387,602,2252,05,26,2018,September,New Castle
979,354,474,1807,06,26,2018,September,New Castle
1188,415,557,2160,07,26,2018,September,New Castle
302,88,134,524,08,26,2018,September,New Castle
1941,336,603,2880,09,26,2018,September,New Castle
1229,605,643,2477,01,27,2018,September,New Castle
744,351,352,1447,02,27,2018,September,New Castle
794,293,364,1451,03,27,2018,September,New Castle
877,496,578,1951,04,27,2018,September,New Castle
937,505,484,1926,05,27,2018,September,New Castle
947,237,373,1557,06,27,2018,September,New Castle
241,238,189,668,07,27,2018,September,New Castle
937,592,570,2099,08,27,2018,September,New Castle
819,644,476,1939,09,27,2018,September,New Castle
829,687,596,2112,10,27,2018,September,New Castle
900,81,177,1158,01,01,2018,October,New Castle
1571,65,190,1826,02,01,2018,October,New Castle
1117,73,169,1359,03,01,2018,October,New Castle
1576,102,274,1952,04,01,2018,October,New Castle
1225,202,335,1762,05,01,2018,October,New Castle
570,47,111,728,06,01,2018,October,New Castle
655,57,144,856,07,01,2018,October,New Castle
149,61,55,265,08,01,2018,October,New Castle
994,105,162,1261,09,01,2018,October,New Castle
1514,76,216,1806,10,01,2018,October,New Castle
726,66,167,959,11,01,2018,October,New Castle
379,120,173,672,12,01,2018,October,New Castle
849,152,209,1210,13,01,2018,October,New Castle
476,229,242,947,14,01,2018,October,New Castle
1865,115,309,2289,01,02,2018,October,New Castle
635,31,97,763,02,02,2018,October,New Castle
224,54,81,359,03,02,2018,October,New Castle
66,33,22,121,04,02,2018,October,New Castle
1034,107,234,1375,05,02,2018,October,New Castle
839,118,304,1261,06,02,2018,October,New Castle
883,122,228,1233,07,02,2018,October,New Castle
943,59,170,1172,08,02,2018,October,New Castle
519,213,238,970,09,02,2018,October,New Castle
1127,195,438,1760,10,02,2018,October,New Castle
1495,68,235,1798,11,02,2018,October,New Castle
941,51,163,1155,12,02,2018,October,New Castle
378,88,209,675,17,02,2018,October,New Castle
1062,93,231,1386,01,03,2018,October,New Castle
1252,234,317,1803,02,03,2018,October,New Castle
585,56,153,794,03,03,2018,October,New Castle
1348,114,272,1734,04,03,2018,October,New Castle
133,9,33,175,05,03,2018,October,New Castle
1189,109,295,1593,06,03,2018,October,New Castle
1643,167,372,2182,07,03,2018,October,New Castle
1087,188,292,1567,08,03,2018,October,New Castle
1551,172,376,2099,09,03,2018,October,New Castle
271,71,94,436,10,03,2018,October,New Castle
1155,351,405,1911,01,04,2018,October,New Castle
592,649,411,1652,02,04,2018,October,New Castle
1019,372,317,1708,03,04,2018,October,New Castle
544,150,185,879,04,04,2018,October,New Castle
287,40,74,401,05,04,2018,October,New Castle
820,303,373,1496,06,04,2018,October,New Castle
965,332,385,1682,07,04,2018,October,New Castle
942,708,748,2398,08,04,2018,October,New Castle
636,89,208,933,09,04,2018,October,New Castle
222,52,67,341,10,04,2018,October,New Castle
559,588,417,1564,11,04,2018,October,New Castle
632,579,496,1707,12,04,2018,October,New Castle
178,51,78,307,13,04,2018,October,New Castle
196,48,60,304,14,04,2018,October,New Castle
214,242,169,625,15,04,2018,October,New Castle
120,28,48,196,16,04,2018,October,New Castle
1448,307,419,2174,01,05,2018,October,New Castle
742,230,293,1265,02,05,2018,October,New Castle
909,161,242,1312,03,05,2018,October,New Castle
1255,142,331,1728,04,05,2018,October,New Castle
971,151,331,1453,05,05,2018,October,New Castle
1104,164,259,1527,06,05,2018,October,New Castle
712,210,308,1230,07,05,2018,October,New Castle
1378,412,494,2284,08,05,2018,October,New Castle
1085,145,223,1453,09,05,2018,October,New Castle
1151,149,288,1588,10,05,2018,October,New Castle
605,334,367,1306,01,06,2018,October,New Castle
695,603,450,1748,02,06,2018,October,New Castle
174,135,110,419,03,06,2018,October,New Castle
672,303,375,1350,04,06,2018,October,New Castle
1156,336,416,1908,05,06,2018,October,New Castle
648,144,196,988,06,06,2018,October,New Castle
491,408,311,1210,07,06,2018,October,New Castle
1002,593,652,2247,08,06,2018,October,New Castle
1026,585,542,2153,09,06,2018,October,New Castle
638,623,450,1711,10,06,2018,October,New Castle
517,451,362,1330,11,06,2018,October,New Castle
725,594,475,1794,12,06,2018,October,New Castle
832,495,479,1806,01,07,2018,October,New Castle
778,608,520,1906,02,07,2018,October,New Castle
661,471,369,1501,03,07,2018,October,New Castle
1428,582,596,2606,04,07,2018,October,New Castle
466,129,267,862,05,07,2018,October,New Castle
532,290,244,1066,06,07,2018,October,New Castle
827,453,402,1682,07,07,2018,October,New Castle
712,573,459,1744,08,07,2018,October,New Castle
719,433,386,1538,09,07,2018,October,New Castle
1354,430,495,2279,10,07,2018,October,New Castle
441,554,368,1363,01,08,2018,October,New Castle
1117,524,516,2157,02,08,2018,October,New Castle
831,417,390,1638,03,08,2018,October,New Castle
1129,239,320,1688,04,08,2018,October,New Castle
1456,586,619,2661,05,08,2018,October,New Castle
871,612,523,2006,06,08,2018,October,New Castle
678,775,462,1915,07,08,2018,October,New Castle
880,537,456,1873,08,08,2018,October,New Castle
151,143,92,386,09,08,2018,October,New Castle
985,423,484,1892,10,08,2018,October,New Castle
703,571,465,1739,01,09,2018,October,New Castle
755,347,363,1465,02,09,2018,October,New Castle
1037,774,607,2418,03,09,2018,October,New Castle
412,434,257,1103,04,09,2018,October,New Castle
477,286,237,1000,05,09,2018,October,New Castle
590,506,456,1552,06,09,2018,October,New Castle
282,289,197,768,07,09,2018,October,New Castle
672,346,340,1358,08,09,2018,October,New Castle
540,520,407,1467,09,09,2018,October,New Castle
699,397,374,1470,10,09,2018,October,New Castle
814,818,667,2299,11,09,2018,October,New Castle
583,397,360,1340,12,09,2018,October,New Castle
775,493,479,1747,13,09,2018,October,New Castle
792,702,488,1982,01,10,2018,October,New Castle
665,483,383,1531,02,10,2018,October,New Castle
556,483,390,1429,03,10,2018,October,New Castle
1124,485,456,2065,04,10,2018,October,New Castle
581,604,412,1597,05,10,2018,October,New Castle
625,631,418,1674,06,10,2018,October,New Castle
779,650,550,1979,07,10,2018,October,New Castle
1079,242,368,1689,08,10,2018,October,New Castle
574,482,352,1408,09,10,2018,October,New Castle
741,187,271,1199,10,10,2018,October,New Castle
771,495,443,1709,01,11,2018,October,New Castle
1135,447,560,2142,02,11,2018,October,New Castle
614,616,561,1791,03,11,2018,October,New Castle
532,332,335,1199,04,11,2018,October,New Castle
720,529,493,1742,01,12,2018,October,New Castle
561,447,363,1371,02,12,2018,October,New Castle
508,410,382,1300,03,12,2018,October,New Castle
377,606,275,1258,04,12,2018,October,New Castle
653,691,474,1818,05,12,2018,October,New Castle
258,356,185,799,06,12,2018,October,New Castle
552,447,378,1377,07,12,2018,October,New Castle
546,683,479,1708,08,12,2018,October,New Castle
535,461,429,1425,09,12,2018,October,New Castle
665,661,518,1844,10,12,2018,October,New Castle
435,753,407,1595,11,12,2018,October,New Castle
470,549,462,1481,12,12,2018,October,New Castle
372,493,259,1124,13,12,2018,October,New Castle
394,373,295,1062,14,12,2018,October,New Castle
921,411,571,1903,01,13,2018,October,New Castle
658,271,387,1316,02,13,2018,October,New Castle
402,51,82,535,03,13,2018,October,New Castle
864,386,520,1770,04,13,2018,October,New Castle
996,372,561,1929,05,13,2018,October,New Castle
1002,470,612,2084,06,13,2018,October,New Castle
355,130,196,681,07,13,2018,October,New Castle
1324,334,551,2209,08,13,2018,October,New Castle
1038,274,447,1759,09,13,2018,October,New Castle
380,172,239,791,10,13,2018,October,New Castle
455,87,175,717,11,13,2018,October,New Castle
10,2,6,18,12,13,2018,October,New Castle
120,20,37,177,13,13,2018,October,New Castle
1156,536,677,2369,01,15,2018,October,New Castle
1091,595,606,2292,02,15,2018,October,New Castle
1294,478,556,2328,03,15,2018,October,New Castle
627,302,293,1222,04,15,2018,October,New Castle
1634,580,653,2867,05,15,2018,October,New Castle
1093,257,450,1800,06,15,2018,October,New Castle
890,418,438,1746,07,15,2018,October,New Castle
589,321,336,1246,08,15,2018,October,New Castle
317,228,226,771,09,15,2018,October,New Castle
1576,361,563,2500,10,15,2018,October,New Castle
1116,335,450,1901,01,16,2018,October,New Castle
1525,171,353,2049,02,16,2018,October,New Castle
1334,64,189,1587,03,16,2018,October,New Castle
645,150,257,1052,04,16,2018,October,New Castle
1539,130,246,1915,05,16,2018,October,New Castle
1079,137,246,1462,06,16,2018,October,New Castle
928,113,242,1283,07,16,2018,October,New Castle
1437,219,324,1980,08,16,2018,October,New Castle
221,90,89,400,09,16,2018,October,New Castle
1054,271,449,1774,10,16,2018,October,New Castle
845,228,338,1411,01,17,2018,October,New Castle
1970,217,443,2630,02,17,2018,October,New Castle
1325,285,350,1960,03,17,2018,October,New Castle
701,338,334,1373,04,17,2018,October,New Castle
709,276,364,1349,05,17,2018,October,New Castle
95,60,65,220,06,17,2018,October,New Castle
868,256,383,1507,07,17,2018,October,New Castle
662,138,192,992,08,17,2018,October,New Castle
630,262,293,1185,09,17,2018,October,New Castle
922,247,397,1566,10,17,2018,October,New Castle
1170,308,499,1977,11,17,2018,October,New Castle
1433,453,597,2483,01,18,2018,October,New Castle
834,293,403,1530,02,18,2018,October,New Castle
624,234,272,1130,03,18,2018,October,New Castle
1212,370,397,1979,04,18,2018,October,New Castle
895,343,387,1625,05,18,2018,October,New Castle
1192,319,437,1948,06,18,2018,October,New Castle
606,239,335,1180,07,18,2018,October,New Castle
906,225,342,1473,08,18,2018,October,New Castle
749,269,314,1332,09,18,2018,October,New Castle
499,189,209,897,10,18,2018,October,New Castle
885,372,480,1737,01,19,2018,October,New Castle
687,298,388,1373,02,19,2018,October,New Castle
620,429,437,1486,03,19,2018,October,New Castle
869,403,525,1797,04,19,2018,October,New Castle
836,429,526,1791,05,19,2018,October,New Castle
250,91,139,480,06,19,2018,October,New Castle
548,270,302,1120,07,19,2018,October,New Castle
750,410,519,1679,08,19,2018,October,New Castle
720,376,457,1553,09,19,2018,October,New Castle
489,252,310,1051,10,19,2018,October,New Castle
180,87,126,393,11,19,2018,October,New Castle
803,197,301,1301,12,19,2018,October,New Castle
352,280,230,862,01,21,2018,October,New Castle
690,395,442,1527,02,21,2018,October,New Castle
828,575,524,1927,03,21,2018,October,New Castle
844,479,523,1846,04,21,2018,October,New Castle
770,659,532,1961,05,21,2018,October,New Castle
862,569,578,2009,06,21,2018,October,New Castle
53,109,71,233,07,21,2018,October,New Castle
1006,553,625,2184,08,21,2018,October,New Castle
376,273,280,929,09,21,2018,October,New Castle
912,611,593,2116,10,21,2018,October,New Castle
946,519,662,2127,11,21,2018,October,New Castle
563,640,486,1689,01,22,2018,October,New Castle
451,516,431,1398,02,22,2018,October,New Castle
539,619,464,1622,03,22,2018,October,New Castle
501,613,440,1554,04,22,2018,October,New Castle
764,903,648,2315,05,22,2018,October,New Castle
252,276,238,766,06,22,2018,October,New Castle
1080,697,724,2501,07,22,2018,October,New Castle
531,398,376,1305,08,22,2018,October,New Castle
519,480,350,1349,09,22,2018,October,New Castle
520,476,431,1427,10,22,2018,October,New Castle
783,637,589,2009,11,22,2018,October,New Castle
411,428,319,1158,12,22,2018,October,New Castle
281,105,186,572,01,23,2018,October,New Castle
734,524,522,1780,02,23,2018,October,New Castle
547,392,390,1329,03,23,2018,October,New Castle
956,521,494,1971,04,23,2018,October,New Castle
961,326,513,1800,05,23,2018,October,New Castle
695,584,501,1780,06,23,2018,October,New Castle
570,450,428,1448,07,23,2018,October,New Castle
578,460,416,1454,08,23,2018,October,New Castle
188,244,177,609,09,23,2018,October,New Castle
953,479,578,2010,01,24,2018,October,New Castle
1072,389,490,1951,02,24,2018,October,New Castle
691,293,369,1353,03,24,2018,October,New Castle
626,144,246,1016,04,24,2018,October,New Castle
1200,425,580,2205,05,24,2018,October,New Castle
598,390,417,1405,06,24,2018,October,New Castle
1228,325,434,1987,07,24,2018,October,New Castle
874,424,538,1836,08,24,2018,October,New Castle
506,244,268,1018,09,24,2018,October,New Castle
789,335,458,1582,10,24,2018,October,New Castle
760,252,410,1422,01,25,2018,October,New Castle
573,424,408,1405,02,25,2018,October,New Castle
734,351,494,1579,03,25,2018,October,New Castle
678,381,404,1463,04,25,2018,October,New Castle
607,425,446,1478,05,25,2018,October,New Castle
995,417,495,1907,06,25,2018,October,New Castle
843,496,595,1934,07,25,2018,October,New Castle
429,180,218,827,08,25,2018,October,New Castle
876,428,480,1784,01,26,2018,October,New Castle
919,225,362,1506,02,26,2018,October,New Castle
676,258,328,1262,03,26,2018,October,New Castle
1091,350,465,1906,04,26,2018,October,New Castle
1263,387,602,2252,05,26,2018,October,New Castle
979,354,474,1807,06,26,2018,October,New Castle
1188,415,557,2160,07,26,2018,October,New Castle
302,88,134,524,08,26,2018,October,New Castle
1941,336,603,2880,09,26,2018,October,New Castle
1229,605,643,2477,01,27,2018,October,New Castle
744,351,352,1447,02,27,2018,October,New Castle
794,293,364,1451,03,27,2018,October,New Castle
877,496,578,1951,04,27,2018,October,New Castle
937,505,484,1926,05,27,2018,October,New Castle
947,237,373,1557,06,27,2018,October,New Castle
241,238,189,668,07,27,2018,October,New Castle
937,592,570,2099,08,27,2018,October,New Castle
819,644,476,1939,09,27,2018,October,New Castle
829,687,596,2112,10,27,2018,October,New Castle
900,81,177,1158,01,01,2018,November,New Castle
1571,65,190,1826,02,01,2018,November,New Castle
1117,73,169,1359,03,01,2018,November,New Castle
1576,102,274,1952,04,01,2018,November,New Castle
1225,202,335,1762,05,01,2018,November,New Castle
570,47,111,728,06,01,2018,November,New Castle
655,57,144,856,07,01,2018,November,New Castle
149,61,55,265,08,01,2018,November,New Castle
994,105,162,1261,09,01,2018,November,New Castle
1514,76,216,1806,10,01,2018,November,New Castle
726,66,167,959,11,01,2018,November,New Castle
379,120,173,672,12,01,2018,November,New Castle
849,152,209,1210,13,01,2018,November,New Castle
476,229,242,947,14,01,2018,November,New Castle
1865,115,309,2289,01,02,2018,November,New Castle
635,31,97,763,02,02,2018,November,New Castle
224,54,81,359,03,02,2018,November,New Castle
66,33,22,121,04,02,2018,November,New Castle
1034,107,234,1375,05,02,2018,November,New Castle
839,118,304,1261,06,02,2018,November,New Castle
883,122,228,1233,07,02,2018,November,New Castle
943,59,170,1172,08,02,2018,November,New Castle
519,213,238,970,09,02,2018,November,New Castle
1127,195,438,1760,10,02,2018,November,New Castle
1495,68,235,1798,11,02,2018,November,New Castle
941,51,163,1155,12,02,2018,November,New Castle
378,88,209,675,17,02,2018,November,New Castle
1062,93,231,1386,01,03,2018,November,New Castle
1252,234,317,1803,02,03,2018,November,New Castle
585,56,153,794,03,03,2018,November,New Castle
1348,114,272,1734,04,03,2018,November,New Castle
133,9,33,175,05,03,2018,November,New Castle
1189,109,295,1593,06,03,2018,November,New Castle
1643,167,372,2182,07,03,2018,November,New Castle
1087,188,292,1567,08,03,2018,November,New Castle
1551,172,376,2099,09,03,2018,November,New Castle
271,71,94,436,10,03,2018,November,New Castle
1155,351,405,1911,01,04,2018,November,New Castle
592,649,411,1652,02,04,2018,November,New Castle
1019,372,317,1708,03,04,2018,November,New Castle
544,150,185,879,04,04,2018,November,New Castle
287,40,74,401,05,04,2018,November,New Castle
820,303,373,1496,06,04,2018,November,New Castle
965,332,385,1682,07,04,2018,November,New Castle
942,708,748,2398,08,04,2018,November,New Castle
636,89,208,933,09,04,2018,November,New Castle
222,52,67,341,10,04,2018,November,New Castle
559,588,417,1564,11,04,2018,November,New Castle
632,579,496,1707,12,04,2018,November,New Castle
178,51,78,307,13,04,2018,November,New Castle
196,48,60,304,14,04,2018,November,New Castle
214,242,169,625,15,04,2018,November,New Castle
120,28,48,196,16,04,2018,November,New Castle
1448,307,419,2174,01,05,2018,November,New Castle
742,230,293,1265,02,05,2018,November,New Castle
909,161,242,1312,03,05,2018,November,New Castle
1255,142,331,1728,04,05,2018,November,New Castle
971,151,331,1453,05,05,2018,November,New Castle
1104,164,259,1527,06,05,2018,November,New Castle
712,210,308,1230,07,05,2018,November,New Castle
1378,412,494,2284,08,05,2018,November,New Castle
1085,145,223,1453,09,05,2018,November,New Castle
1151,149,288,1588,10,05,2018,November,New Castle
605,334,367,1306,01,06,2018,November,New Castle
695,603,450,1748,02,06,2018,November,New Castle
174,135,110,419,03,06,2018,November,New Castle
672,303,375,1350,04,06,2018,November,New Castle
1156,336,416,1908,05,06,2018,November,New Castle
648,144,196,988,06,06,2018,November,New Castle
491,408,311,1210,07,06,2018,November,New Castle
1002,593,652,2247,08,06,2018,November,New Castle
1026,585,542,2153,09,06,2018,November,New Castle
638,623,450,1711,10,06,2018,November,New Castle
517,451,362,1330,11,06,2018,November,New Castle
725,594,475,1794,12,06,2018,November,New Castle
832,495,479,1806,01,07,2018,November,New Castle
778,608,520,1906,02,07,2018,November,New Castle
661,471,369,1501,03,07,2018,November,New Castle
1428,582,596,2606,04,07,2018,November,New Castle
466,129,267,862,05,07,2018,November,New Castle
532,290,244,1066,06,07,2018,November,New Castle
827,453,402,1682,07,07,2018,November,New Castle
712,573,459,1744,08,07,2018,November,New Castle
719,433,386,1538,09,07,2018,November,New Castle
1354,430,495,2279,10,07,2018,November,New Castle
441,554,368,1363,01,08,2018,November,New Castle
1117,524,516,2157,02,08,2018,November,New Castle
831,417,390,1638,03,08,2018,November,New Castle
1129,239,320,1688,04,08,2018,November,New Castle
1456,586,619,2661,05,08,2018,November,New Castle
871,612,523,2006,06,08,2018,November,New Castle
678,775,462,1915,07,08,2018,November,New Castle
880,537,456,1873,08,08,2018,November,New Castle
151,143,92,386,09,08,2018,November,New Castle
985,423,484,1892,10,08,2018,November,New Castle
703,571,465,1739,01,09,2018,November,New Castle
755,347,363,1465,02,09,2018,November,New Castle
1037,774,607,2418,03,09,2018,November,New Castle
412,434,257,1103,04,09,2018,November,New Castle
477,286,237,1000,05,09,2018,November,New Castle
590,506,456,1552,06,09,2018,November,New Castle
282,289,197,768,07,09,2018,November,New Castle
672,346,340,1358,08,09,2018,November,New Castle
540,520,407,1467,09,09,2018,November,New Castle
699,397,374,1470,10,09,2018,November,New Castle
814,818,667,2299,11,09,2018,November,New Castle
583,397,360,1340,12,09,2018,November,New Castle
775,493,479,1747,13,09,2018,November,New Castle
792,702,488,1982,01,10,2018,November,New Castle
665,483,383,1531,02,10,2018,November,New Castle
556,483,390,1429,03,10,2018,November,New Castle
1124,485,456,2065,04,10,2018,November,New Castle
581,604,412,1597,05,10,2018,November,New Castle
625,631,418,1674,06,10,2018,November,New Castle
779,650,550,1979,07,10,2018,November,New Castle
1079,242,368,1689,08,10,2018,November,New Castle
574,482,352,1408,09,10,2018,November,New Castle
741,187,271,1199,10,10,2018,November,New Castle
771,495,443,1709,01,11,2018,November,New Castle
1135,447,560,2142,02,11,2018,November,New Castle
614,616,561,1791,03,11,2018,November,New Castle
532,332,335,1199,04,11,2018,November,New Castle
720,529,493,1742,01,12,2018,November,New Castle
561,447,363,1371,02,12,2018,November,New Castle
508,410,382,1300,03,12,2018,November,New Castle
377,606,275,1258,04,12,2018,November,New Castle
653,691,474,1818,05,12,2018,November,New Castle
258,356,185,799,06,12,2018,November,New Castle
552,447,378,1377,07,12,2018,November,New Castle
546,683,479,1708,08,12,2018,November,New Castle
535,461,429,1425,09,12,2018,November,New Castle
665,661,518,1844,10,12,2018,November,New Castle
435,753,407,1595,11,12,2018,November,New Castle
470,549,462,1481,12,12,2018,November,New Castle
372,493,259,1124,13,12,2018,November,New Castle
394,373,295,1062,14,12,2018,November,New Castle
921,411,571,1903,01,13,2018,November,New Castle
658,271,387,1316,02,13,2018,November,New Castle
402,51,82,535,03,13,2018,November,New Castle
864,386,520,1770,04,13,2018,November,New Castle
996,372,561,1929,05,13,2018,November,New Castle
1002,470,612,2084,06,13,2018,November,New Castle
355,130,196,681,07,13,2018,November,New Castle
1324,334,551,2209,08,13,2018,November,New Castle
1038,274,447,1759,09,13,2018,November,New Castle
380,172,239,791,10,13,2018,November,New Castle
455,87,175,717,11,13,2018,November,New Castle
10,2,6,18,12,13,2018,November,New Castle
120,20,37,177,13,13,2018,November,New Castle
1156,536,677,2369,01,15,2018,November,New Castle
1091,595,606,2292,02,15,2018,November,New Castle
1294,478,556,2328,03,15,2018,November,New Castle
627,302,293,1222,04,15,2018,November,New Castle
1634,580,653,2867,05,15,2018,November,New Castle
1093,257,450,1800,06,15,2018,November,New Castle
890,418,438,1746,07,15,2018,November,New Castle
589,321,336,1246,08,15,2018,November,New Castle
317,228,226,771,09,15,2018,November,New Castle
1576,361,563,2500,10,15,2018,November,New Castle
1116,335,450,1901,01,16,2018,November,New Castle
1525,171,353,2049,02,16,2018,November,New Castle
1334,64,189,1587,03,16,2018,November,New Castle
645,150,257,1052,04,16,2018,November,New Castle
1539,130,246,1915,05,16,2018,November,New Castle
1079,137,246,1462,06,16,2018,November,New Castle
928,113,242,1283,07,16,2018,November,New Castle
1437,219,324,1980,08,16,2018,November,New Castle
221,90,89,400,09,16,2018,November,New Castle
1054,271,449,1774,10,16,2018,November,New Castle
845,228,338,1411,01,17,2018,November,New Castle
1970,217,443,2630,02,17,2018,November,New Castle
1325,285,350,1960,03,17,2018,November,New Castle
701,338,334,1373,04,17,2018,November,New Castle
709,276,364,1349,05,17,2018,November,New Castle
95,60,65,220,06,17,2018,November,New Castle
868,256,383,1507,07,17,2018,November,New Castle
662,138,192,992,08,17,2018,November,New Castle
630,262,293,1185,09,17,2018,November,New Castle
922,247,397,1566,10,17,2018,November,New Castle
1170,308,499,1977,11,17,2018,November,New Castle
1433,453,597,2483,01,18,2018,November,New Castle
834,293,403,1530,02,18,2018,November,New Castle
624,234,272,1130,03,18,2018,November,New Castle
1212,370,397,1979,04,18,2018,November,New Castle
895,343,387,1625,05,18,2018,November,New Castle
1192,319,437,1948,06,18,2018,November,New Castle
606,239,335,1180,07,18,2018,November,New Castle
906,225,342,1473,08,18,2018,November,New Castle
749,269,314,1332,09,18,2018,November,New Castle
499,189,209,897,10,18,2018,November,New Castle
885,372,480,1737,01,19,2018,November,New Castle
687,298,388,1373,02,19,2018,November,New Castle
620,429,437,1486,03,19,2018,November,New Castle
869,403,525,1797,04,19,2018,November,New Castle
836,429,526,1791,05,19,2018,November,New Castle
250,91,139,480,06,19,2018,November,New Castle
548,270,302,1120,07,19,2018,November,New Castle
750,410,519,1679,08,19,2018,November,New Castle
720,376,457,1553,09,19,2018,November,New Castle
489,252,310,1051,10,19,2018,November,New Castle
180,87,126,393,11,19,2018,November,New Castle
803,197,301,1301,12,19,2018,November,New Castle
352,280,230,862,01,21,2018,November,New Castle
690,395,442,1527,02,21,2018,November,New Castle
828,575,524,1927,03,21,2018,November,New Castle
844,479,523,1846,04,21,2018,November,New Castle
770,659,532,1961,05,21,2018,November,New Castle
862,569,578,2009,06,21,2018,November,New Castle
53,109,71,233,07,21,2018,November,New Castle
1006,553,625,2184,08,21,2018,November,New Castle
376,273,280,929,09,21,2018,November,New Castle
912,611,593,2116,10,21,2018,November,New Castle
946,519,662,2127,11,21,2018,November,New Castle
563,640,486,1689,01,22,2018,November,New Castle
451,516,431,1398,02,22,2018,November,New Castle
539,619,464,1622,03,22,2018,November,New Castle
501,613,440,1554,04,22,2018,November,New Castle
764,903,648,2315,05,22,2018,November,New Castle
252,276,238,766,06,22,2018,November,New Castle
1080,697,724,2501,07,22,2018,November,New Castle
531,398,376,1305,08,22,2018,November,New Castle
519,480,350,1349,09,22,2018,November,New Castle
520,476,431,1427,10,22,2018,November,New Castle
783,637,589,2009,11,22,2018,November,New Castle
411,428,319,1158,12,22,2018,November,New Castle
281,105,186,572,01,23,2018,November,New Castle
734,524,522,1780,02,23,2018,November,New Castle
547,392,390,1329,03,23,2018,November,New Castle
956,521,494,1971,04,23,2018,November,New Castle
961,326,513,1800,05,23,2018,November,New Castle
695,584,501,1780,06,23,2018,November,New Castle
570,450,428,1448,07,23,2018,November,New Castle
578,460,416,1454,08,23,2018,November,New Castle
188,244,177,609,09,23,2018,November,New Castle
953,479,578,2010,01,24,2018,November,New Castle
1072,389,490,1951,02,24,2018,November,New Castle
691,293,369,1353,03,24,2018,November,New Castle
626,144,246,1016,04,24,2018,November,New Castle
1200,425,580,2205,05,24,2018,November,New Castle
598,390,417,1405,06,24,2018,November,New Castle
1228,325,434,1987,07,24,2018,November,New Castle
874,424,538,1836,08,24,2018,November,New Castle
506,244,268,1018,09,24,2018,November,New Castle
789,335,458,1582,10,24,2018,November,New Castle
760,252,410,1422,01,25,2018,November,New Castle
573,424,408,1405,02,25,2018,November,New Castle
734,351,494,1579,03,25,2018,November,New Castle
678,381,404,1463,04,25,2018,November,New Castle
607,425,446,1478,05,25,2018,November,New Castle
995,417,495,1907,06,25,2018,November,New Castle
843,496,595,1934,07,25,2018,November,New Castle
429,180,218,827,08,25,2018,November,New Castle
876,428,480,1784,01,26,2018,November,New Castle
919,225,362,1506,02,26,2018,November,New Castle
676,258,328,1262,03,26,2018,November,New Castle
1091,350,465,1906,04,26,2018,November,New Castle
1263,387,602,2252,05,26,2018,November,New Castle
979,354,474,1807,06,26,2018,November,New Castle
1188,415,557,2160,07,26,2018,November,New Castle
302,88,134,524,08,26,2018,November,New Castle
1941,336,603,2880,09,26,2018,November,New Castle
1229,605,643,2477,01,27,2018,November,New Castle
744,351,352,1447,02,27,2018,November,New Castle
794,293,364,1451,03,27,2018,November,New Castle
877,496,578,1951,04,27,2018,November,New Castle
937,505,484,1926,05,27,2018,November,New Castle
947,237,373,1557,06,27,2018,November,New Castle
241,238,189,668,07,27,2018,November,New Castle
937,592,570,2099,08,27,2018,November,New Castle
819,644,476,1939,09,27,2018,November,New Castle
829,687,596,2112,10,27,2018,November,New Castle
1585,1528,1105,4218,01,14,2018,January,Sussex
1246,1119,797,3162,02,14,2018,January,Sussex
1404,982,667,3053,03,14,2018,January,Sussex
1556,1243,883,3682,04,14,2018,January,Sussex
1326,1199,832,3357,05,14,2018,January,Sussex
867,700,458,2025,06,14,2018,January,Sussex
722,605,444,1771,07,14,2018,January,Sussex
850,511,434,1795,01,20,2018,January,Sussex
1165,1187,818,3170,02,20,2018,January,Sussex
1084,1300,816,3200,03,20,2018,January,Sussex
1300,1312,927,3539,04,20,2018,January,Sussex
1589,1525,1086,4200,05,20,2018,January,Sussex
713,817,603,2133,06,20,2018,January,Sussex
1097,914,683,2694,07,20,2018,January,Sussex
176,258,172,606,08,20,2018,January,Sussex
134,157,102,393,09,20,2018,January,Sussex
115,178,89,382,10,20,2018,January,Sussex
1142,1657,898,3697,01,35,2018,January,Sussex
1206,1290,761,3257,02,35,2018,January,Sussex
814,582,430,1826,03,35,2018,January,Sussex
1313,872,585,2770,04,35,2018,January,Sussex
250,318,173,741,05,35,2018,January,Sussex
335,482,228,1045,06,35,2018,January,Sussex
668,666,457,1791,07,35,2018,January,Sussex
925,835,708,2468,01,36,2018,January,Sussex
654,989,588,2231,02,36,2018,January,Sussex
906,988,714,2608,03,36,2018,January,Sussex
631,492,374,1497,04,36,2018,January,Sussex
389,572,310,1271,05,36,2018,January,Sussex
943,666,515,2124,06,36,2018,January,Sussex
806,571,426,1803,07,36,2018,January,Sussex
123,124,105,352,08,36,2018,January,Sussex
44,77,37,158,09,36,2018,January,Sussex
91,86,43,220,10,36,2018,January,Sussex
140,166,100,406,11,36,2018,January,Sussex
1089,678,537,2304,01,37,2018,January,Sussex
531,787,365,1683,02,37,2018,January,Sussex
1048,1331,814,3193,03,37,2018,January,Sussex
1308,1259,797,3364,04,37,2018,January,Sussex
1160,1026,733,2919,05,37,2018,January,Sussex
801,756,503,2060,06,37,2018,January,Sussex
598,842,426,1866,07,37,2018,January,Sussex
817,1352,664,2833,01,38,2018,January,Sussex
1118,1507,768,3393,02,38,2018,January,Sussex
1059,1447,763,3269,03,38,2018,January,Sussex
863,1161,610,2634,04,38,2018,January,Sussex
585,915,470,1970,05,38,2018,January,Sussex
958,1518,599,3075,06,38,2018,January,Sussex
1051,1564,833,3448,07,38,2018,January,Sussex
501,880,411,1792,08,38,2018,January,Sussex
647,1014,495,2156,01,39,2018,January,Sussex
1292,1001,653,2946,02,39,2018,January,Sussex
615,761,411,1787,03,39,2018,January,Sussex
1053,638,483,2174,04,39,2018,January,Sussex
498,792,397,1687,05,39,2018,January,Sussex
1035,1035,595,2665,06,39,2018,January,Sussex
795,732,477,2004,07,39,2018,January,Sussex
696,577,419,1692,01,40,2018,January,Sussex
928,1444,740,3112,02,40,2018,January,Sussex
919,435,357,1711,03,40,2018,January,Sussex
715,1010,484,2209,04,40,2018,January,Sussex
549,548,350,1447,05,40,2018,January,Sussex
599,1014,506,2119,06,40,2018,January,Sussex
1054,1111,657,2822,07,40,2018,January,Sussex
426,450,294,1170,08,40,2018,January,Sussex
678,1151,505,2334,01,41,2018,January,Sussex
1014,1271,740,3025,02,41,2018,January,Sussex
744,554,349,1647,03,41,2018,January,Sussex
563,619,323,1505,04,41,2018,January,Sussex
1481,1153,731,3365,05,41,2018,January,Sussex
480,600,279,1359,06,41,2018,January,Sussex
710,665,390,1765,07,41,2018,January,Sussex
363,429,191,983,08,41,2018,January,Sussex
52,12,23,87,16,41,2018,January,Sussex
1585,1528,1105,4218,01,14,2018,Februay,Sussex
1246,1119,797,3162,02,14,2018,Februay,Sussex
1404,982,667,3053,03,14,2018,Februay,Sussex
1556,1243,883,3682,04,14,2018,Februay,Sussex
1326,1199,832,3357,05,14,2018,Februay,Sussex
867,700,458,2025,06,14,2018,Februay,Sussex
722,605,444,1771,07,14,2018,Februay,Sussex
850,511,434,1795,01,20,2018,Februay,Sussex
1165,1187,818,3170,02,20,2018,Februay,Sussex
1084,1300,816,3200,03,20,2018,Februay,Sussex
1300,1312,927,3539,04,20,2018,Februay,Sussex
1589,1525,1086,4200,05,20,2018,Februay,Sussex
713,817,603,2133,06,20,2018,Februay,Sussex
1097,914,683,2694,07,20,2018,Februay,Sussex
176,258,172,606,08,20,2018,Februay,Sussex
134,157,102,393,09,20,2018,Februay,Sussex
115,178,89,382,10,20,2018,Februay,Sussex
1142,1657,898,3697,01,35,2018,Februay,Sussex
1206,1290,761,3257,02,35,2018,Februay,Sussex
814,582,430,1826,03,35,2018,Februay,Sussex
1313,872,585,2770,04,35,2018,Februay,Sussex
250,318,173,741,05,35,2018,Februay,Sussex
335,482,228,1045,06,35,2018,Februay,Sussex
668,666,457,1791,07,35,2018,Februay,Sussex
925,835,708,2468,01,36,2018,Februay,Sussex
654,989,588,2231,02,36,2018,Februay,Sussex
906,988,714,2608,03,36,2018,Februay,Sussex
631,492,374,1497,04,36,2018,Februay,Sussex
389,572,310,1271,05,36,2018,Februay,Sussex
943,666,515,2124,06,36,2018,Februay,Sussex
806,571,426,1803,07,36,2018,Februay,Sussex
123,124,105,352,08,36,2018,Februay,Sussex
44,77,37,158,09,36,2018,Februay,Sussex
91,86,43,220,10,36,2018,Februay,Sussex
140,166,100,406,11,36,2018,Februay,Sussex
1089,678,537,2304,01,37,2018,Februay,Sussex
531,787,365,1683,02,37,2018,Februay,Sussex
1048,1331,814,3193,03,37,2018,Februay,Sussex
1308,1259,797,3364,04,37,2018,Februay,Sussex
1160,1026,733,2919,05,37,2018,Februay,Sussex
801,756,503,2060,06,37,2018,Februay,Sussex
598,842,426,1866,07,37,2018,Februay,Sussex
817,1352,664,2833,01,38,2018,Februay,Sussex
1118,1507,768,3393,02,38,2018,Februay,Sussex
1059,1447,763,3269,03,38,2018,Februay,Sussex
863,1161,610,2634,04,38,2018,Februay,Sussex
585,915,470,1970,05,38,2018,Februay,Sussex
958,1518,599,3075,06,38,2018,Februay,Sussex
1051,1564,833,3448,07,38,2018,Februay,Sussex
501,880,411,1792,08,38,2018,Februay,Sussex
647,1014,495,2156,01,39,2018,Februay,Sussex
1292,1001,653,2946,02,39,2018,Februay,Sussex
615,761,411,1787,03,39,2018,Februay,Sussex
1053,638,483,2174,04,39,2018,Februay,Sussex
498,792,397,1687,05,39,2018,Februay,Sussex
1035,1035,595,2665,06,39,2018,Februay,Sussex
795,732,477,2004,07,39,2018,Februay,Sussex
696,577,419,1692,01,40,2018,Februay,Sussex
928,1444,740,3112,02,40,2018,Februay,Sussex
919,435,357,1711,03,40,2018,Februay,Sussex
715,1010,484,2209,04,40,2018,Februay,Sussex
549,548,350,1447,05,40,2018,Februay,Sussex
599,1014,506,2119,06,40,2018,Februay,Sussex
1054,1111,657,2822,07,40,2018,Februay,Sussex
426,450,294,1170,08,40,2018,Februay,Sussex
678,1151,505,2334,01,41,2018,Februay,Sussex
1014,1271,740,3025,02,41,2018,Februay,Sussex
744,554,349,1647,03,41,2018,Februay,Sussex
563,619,323,1505,04,41,2018,Februay,Sussex
1481,1153,731,3365,05,41,2018,Februay,Sussex
480,600,279,1359,06,41,2018,Februay,Sussex
710,665,390,1765,07,41,2018,Februay,Sussex
363,429,191,983,08,41,2018,Februay,Sussex
52,12,23,87,16,41,2018,Februay,Sussex
1585,1528,1105,4218,01,14,2018,March,Sussex
1246,1119,797,3162,02,14,2018,March,Sussex
1404,982,667,3053,03,14,2018,March,Sussex
1556,1243,883,3682,04,14,2018,March,Sussex
1326,1199,832,3357,05,14,2018,March,Sussex
867,700,458,2025,06,14,2018,March,Sussex
722,605,444,1771,07,14,2018,March,Sussex
850,511,434,1795,01,20,2018,March,Sussex
1165,1187,818,3170,02,20,2018,March,Sussex
1084,1300,816,3200,03,20,2018,March,Sussex
1300,1312,927,3539,04,20,2018,March,Sussex
1589,1525,1086,4200,05,20,2018,March,Sussex
713,817,603,2133,06,20,2018,March,Sussex
1097,914,683,2694,07,20,2018,March,Sussex
176,258,172,606,08,20,2018,March,Sussex
134,157,102,393,09,20,2018,March,Sussex
115,178,89,382,10,20,2018,March,Sussex
1142,1657,898,3697,01,35,2018,March,Sussex
1206,1290,761,3257,02,35,2018,March,Sussex
814,582,430,1826,03,35,2018,March,Sussex
1313,872,585,2770,04,35,2018,March,Sussex
250,318,173,741,05,35,2018,March,Sussex
335,482,228,1045,06,35,2018,March,Sussex
668,666,457,1791,07,35,2018,March,Sussex
925,835,708,2468,01,36,2018,March,Sussex
654,989,588,2231,02,36,2018,March,Sussex
906,988,714,2608,03,36,2018,March,Sussex
631,492,374,1497,04,36,2018,March,Sussex
389,572,310,1271,05,36,2018,March,Sussex
943,666,515,2124,06,36,2018,March,Sussex
806,571,426,1803,07,36,2018,March,Sussex
123,124,105,352,08,36,2018,March,Sussex
44,77,37,158,09,36,2018,March,Sussex
91,86,43,220,10,36,2018,March,Sussex
140,166,100,406,11,36,2018,March,Sussex
1089,678,537,2304,01,37,2018,March,Sussex
531,787,365,1683,02,37,2018,March,Sussex
1048,1331,814,3193,03,37,2018,March,Sussex
1308,1259,797,3364,04,37,2018,March,Sussex
1160,1026,733,2919,05,37,2018,March,Sussex
801,756,503,2060,06,37,2018,March,Sussex
598,842,426,1866,07,37,2018,March,Sussex
817,1352,664,2833,01,38,2018,March,Sussex
1118,1507,768,3393,02,38,2018,March,Sussex
1059,1447,763,3269,03,38,2018,March,Sussex
863,1161,610,2634,04,38,2018,March,Sussex
585,915,470,1970,05,38,2018,March,Sussex
958,1518,599,3075,06,38,2018,March,Sussex
1051,1564,833,3448,07,38,2018,March,Sussex
501,880,411,1792,08,38,2018,March,Sussex
647,1014,495,2156,01,39,2018,March,Sussex
1292,1001,653,2946,02,39,2018,March,Sussex
615,761,411,1787,03,39,2018,March,Sussex
1053,638,483,2174,04,39,2018,March,Sussex
498,792,397,1687,05,39,2018,March,Sussex
1035,1035,595,2665,06,39,2018,March,Sussex
795,732,477,2004,07,39,2018,March,Sussex
696,577,419,1692,01,40,2018,March,Sussex
928,1444,740,3112,02,40,2018,March,Sussex
919,435,357,1711,03,40,2018,March,Sussex
715,1010,484,2209,04,40,2018,March,Sussex
549,548,350,1447,05,40,2018,March,Sussex
599,1014,506,2119,06,40,2018,March,Sussex
1054,1111,657,2822,07,40,2018,March,Sussex
426,450,294,1170,08,40,2018,March,Sussex
678,1151,505,2334,01,41,2018,March,Sussex
1014,1271,740,3025,02,41,2018,March,Sussex
744,554,349,1647,03,41,2018,March,Sussex
563,619,323,1505,04,41,2018,March,Sussex
1481,1153,731,3365,05,41,2018,March,Sussex
480,600,279,1359,06,41,2018,March,Sussex
710,665,390,1765,07,41,2018,March,Sussex
363,429,191,983,08,41,2018,March,Sussex
52,12,23,87,16,41,2018,March,Sussex
1585,1528,1105,4218,01,14,2018,April,Sussex
1246,1119,797,3162,02,14,2018,April,Sussex
1404,982,667,3053,03,14,2018,April,Sussex
1556,1243,883,3682,04,14,2018,April,Sussex
1326,1199,832,3357,05,14,2018,April,Sussex
867,700,458,2025,06,14,2018,April,Sussex
722,605,444,1771,07,14,2018,April,Sussex
850,511,434,1795,01,20,2018,April,Sussex
1165,1187,818,3170,02,20,2018,April,Sussex
1084,1300,816,3200,03,20,2018,April,Sussex
1300,1312,927,3539,04,20,2018,April,Sussex
1589,1525,1086,4200,05,20,2018,April,Sussex
713,817,603,2133,06,20,2018,April,Sussex
1097,914,683,2694,07,20,2018,April,Sussex
176,258,172,606,08,20,2018,April,Sussex
134,157,102,393,09,20,2018,April,Sussex
115,178,89,382,10,20,2018,April,Sussex
1142,1657,898,3697,01,35,2018,April,Sussex
1206,1290,761,3257,02,35,2018,April,Sussex
814,582,430,1826,03,35,2018,April,Sussex
1313,872,585,2770,04,35,2018,April,Sussex
250,318,173,741,05,35,2018,April,Sussex
335,482,228,1045,06,35,2018,April,Sussex
668,666,457,1791,07,35,2018,April,Sussex
925,835,708,2468,01,36,2018,April,Sussex
654,989,588,2231,02,36,2018,April,Sussex
906,988,714,2608,03,36,2018,April,Sussex
631,492,374,1497,04,36,2018,April,Sussex
389,572,310,1271,05,36,2018,April,Sussex
943,666,515,2124,06,36,2018,April,Sussex
806,571,426,1803,07,36,2018,April,Sussex
123,124,105,352,08,36,2018,April,Sussex
44,77,37,158,09,36,2018,April,Sussex
91,86,43,220,10,36,2018,April,Sussex
140,166,100,406,11,36,2018,April,Sussex
1089,678,537,2304,01,37,2018,April,Sussex
531,787,365,1683,02,37,2018,April,Sussex
1048,1331,814,3193,03,37,2018,April,Sussex
1308,1259,797,3364,04,37,2018,April,Sussex
1160,1026,733,2919,05,37,2018,April,Sussex
801,756,503,2060,06,37,2018,April,Sussex
598,842,426,1866,07,37,2018,April,Sussex
817,1352,664,2833,01,38,2018,April,Sussex
1118,1507,768,3393,02,38,2018,April,Sussex
1059,1447,763,3269,03,38,2018,April,Sussex
863,1161,610,2634,04,38,2018,April,Sussex
585,915,470,1970,05,38,2018,April,Sussex
958,1518,599,3075,06,38,2018,April,Sussex
1051,1564,833,3448,07,38,2018,April,Sussex
501,880,411,1792,08,38,2018,April,Sussex
647,1014,495,2156,01,39,2018,April,Sussex
1292,1001,653,2946,02,39,2018,April,Sussex
615,761,411,1787,03,39,2018,April,Sussex
1053,638,483,2174,04,39,2018,April,Sussex
498,792,397,1687,05,39,2018,April,Sussex
1035,1035,595,2665,06,39,2018,April,Sussex
795,732,477,2004,07,39,2018,April,Sussex
696,577,419,1692,01,40,2018,April,Sussex
928,1444,740,3112,02,40,2018,April,Sussex
919,435,357,1711,03,40,2018,April,Sussex
715,1010,484,2209,04,40,2018,April,Sussex
549,548,350,1447,05,40,2018,April,Sussex
599,1014,506,2119,06,40,2018,April,Sussex
1054,1111,657,2822,07,40,2018,April,Sussex
426,450,294,1170,08,40,2018,April,Sussex
678,1151,505,2334,01,41,2018,April,Sussex
1014,1271,740,3025,02,41,2018,April,Sussex
744,554,349,1647,03,41,2018,April,Sussex
563,619,323,1505,04,41,2018,April,Sussex
1481,1153,731,3365,05,41,2018,April,Sussex
480,600,279,1359,06,41,2018,April,Sussex
710,665,390,1765,07,41,2018,April,Sussex
363,429,191,983,08,41,2018,April,Sussex
52,12,23,87,16,41,2018,April,Sussex
1585,1528,1105,4218,01,14,2018,May,Sussex
1246,1119,797,3162,02,14,2018,May,Sussex
1404,982,667,3053,03,14,2018,May,Sussex
1556,1243,883,3682,04,14,2018,May,Sussex
1326,1199,832,3357,05,14,2018,May,Sussex
867,700,458,2025,06,14,2018,May,Sussex
722,605,444,1771,07,14,2018,May,Sussex
850,511,434,1795,01,20,2018,May,Sussex
1165,1187,818,3170,02,20,2018,May,Sussex
1084,1300,816,3200,03,20,2018,May,Sussex
1300,1312,927,3539,04,20,2018,May,Sussex
1589,1525,1086,4200,05,20,2018,May,Sussex
713,817,603,2133,06,20,2018,May,Sussex
1097,914,683,2694,07,20,2018,May,Sussex
176,258,172,606,08,20,2018,May,Sussex
134,157,102,393,09,20,2018,May,Sussex
115,178,89,382,10,20,2018,May,Sussex
1142,1657,898,3697,01,35,2018,May,Sussex
1206,1290,761,3257,02,35,2018,May,Sussex
814,582,430,1826,03,35,2018,May,Sussex
1313,872,585,2770,04,35,2018,May,Sussex
250,318,173,741,05,35,2018,May,Sussex
335,482,228,1045,06,35,2018,May,Sussex
668,666,457,1791,07,35,2018,May,Sussex
925,835,708,2468,01,36,2018,May,Sussex
654,989,588,2231,02,36,2018,May,Sussex
906,988,714,2608,03,36,2018,May,Sussex
631,492,374,1497,04,36,2018,May,Sussex
389,572,310,1271,05,36,2018,May,Sussex
943,666,515,2124,06,36,2018,May,Sussex
806,571,426,1803,07,36,2018,May,Sussex
123,124,105,352,08,36,2018,May,Sussex
44,77,37,158,09,36,2018,May,Sussex
91,86,43,220,10,36,2018,May,Sussex
140,166,100,406,11,36,2018,May,Sussex
1089,678,537,2304,01,37,2018,May,Sussex
531,787,365,1683,02,37,2018,May,Sussex
1048,1331,814,3193,03,37,2018,May,Sussex
1308,1259,797,3364,04,37,2018,May,Sussex
1160,1026,733,2919,05,37,2018,May,Sussex
801,756,503,2060,06,37,2018,May,Sussex
598,842,426,1866,07,37,2018,May,Sussex
817,1352,664,2833,01,38,2018,May,Sussex
1118,1507,768,3393,02,38,2018,May,Sussex
1059,1447,763,3269,03,38,2018,May,Sussex
863,1161,610,2634,04,38,2018,May,Sussex
585,915,470,1970,05,38,2018,May,Sussex
958,1518,599,3075,06,38,2018,May,Sussex
1051,1564,833,3448,07,38,2018,May,Sussex
501,880,411,1792,08,38,2018,May,Sussex
647,1014,495,2156,01,39,2018,May,Sussex
1292,1001,653,2946,02,39,2018,May,Sussex
615,761,411,1787,03,39,2018,May,Sussex
1053,638,483,2174,04,39,2018,May,Sussex
498,792,397,1687,05,39,2018,May,Sussex
1035,1035,595,2665,06,39,2018,May,Sussex
795,732,477,2004,07,39,2018,May,Sussex
696,577,419,1692,01,40,2018,May,Sussex
928,1444,740,3112,02,40,2018,May,Sussex
919,435,357,1711,03,40,2018,May,Sussex
715,1010,484,2209,04,40,2018,May,Sussex
549,548,350,1447,05,40,2018,May,Sussex
599,1014,506,2119,06,40,2018,May,Sussex
1054,1111,657,2822,07,40,2018,May,Sussex
426,450,294,1170,08,40,2018,May,Sussex
678,1151,505,2334,01,41,2018,May,Sussex
1014,1271,740,3025,02,41,2018,May,Sussex
744,554,349,1647,03,41,2018,May,Sussex
563,619,323,1505,04,41,2018,May,Sussex
1481,1153,731,3365,05,41,2018,May,Sussex
480,600,279,1359,06,41,2018,May,Sussex
710,665,390,1765,07,41,2018,May,Sussex
363,429,191,983,08,41,2018,May,Sussex
52,12,23,87,16,41,2018,May,Sussex
1585,1528,1105,4218,01,14,2018,June,Sussex
1246,1119,797,3162,02,14,2018,June,Sussex
1404,982,667,3053,03,14,2018,June,Sussex
1556,1243,883,3682,04,14,2018,June,Sussex
1326,1199,832,3357,05,14,2018,June,Sussex
867,700,458,2025,06,14,2018,June,Sussex
722,605,444,1771,07,14,2018,June,Sussex
850,511,434,1795,01,20,2018,June,Sussex
1165,1187,818,3170,02,20,2018,June,Sussex
1084,1300,816,3200,03,20,2018,June,Sussex
1300,1312,927,3539,04,20,2018,June,Sussex
1589,1525,1086,4200,05,20,2018,June,Sussex
713,817,603,2133,06,20,2018,June,Sussex
1097,914,683,2694,07,20,2018,June,Sussex
176,258,172,606,08,20,2018,June,Sussex
134,157,102,393,09,20,2018,June,Sussex
115,178,89,382,10,20,2018,June,Sussex
1142,1657,898,3697,01,35,2018,June,Sussex
1206,1290,761,3257,02,35,2018,June,Sussex
814,582,430,1826,03,35,2018,June,Sussex
1313,872,585,2770,04,35,2018,June,Sussex
250,318,173,741,05,35,2018,June,Sussex
335,482,228,1045,06,35,2018,June,Sussex
668,666,457,1791,07,35,2018,June,Sussex
925,835,708,2468,01,36,2018,June,Sussex
654,989,588,2231,02,36,2018,June,Sussex
906,988,714,2608,03,36,2018,June,Sussex
631,492,374,1497,04,36,2018,June,Sussex
389,572,310,1271,05,36,2018,June,Sussex
943,666,515,2124,06,36,2018,June,Sussex
806,571,426,1803,07,36,2018,June,Sussex
123,124,105,352,08,36,2018,June,Sussex
44,77,37,158,09,36,2018,June,Sussex
91,86,43,220,10,36,2018,June,Sussex
140,166,100,406,11,36,2018,June,Sussex
1089,678,537,2304,01,37,2018,June,Sussex
531,787,365,1683,02,37,2018,June,Sussex
1048,1331,814,3193,03,37,2018,June,Sussex
1308,1259,797,3364,04,37,2018,June,Sussex
1160,1026,733,2919,05,37,2018,June,Sussex
801,756,503,2060,06,37,2018,June,Sussex
598,842,426,1866,07,37,2018,June,Sussex
817,1352,664,2833,01,38,2018,June,Sussex
1118,1507,768,3393,02,38,2018,June,Sussex
1059,1447,763,3269,03,38,2018,June,Sussex
863,1161,610,2634,04,38,2018,June,Sussex
585,915,470,1970,05,38,2018,June,Sussex
958,1518,599,3075,06,38,2018,June,Sussex
1051,1564,833,3448,07,38,2018,June,Sussex
501,880,411,1792,08,38,2018,June,Sussex
647,1014,495,2156,01,39,2018,June,Sussex
1292,1001,653,2946,02,39,2018,June,Sussex
615,761,411,1787,03,39,2018,June,Sussex
1053,638,483,2174,04,39,2018,June,Sussex
498,792,397,1687,05,39,2018,June,Sussex
1035,1035,595,2665,06,39,2018,June,Sussex
795,732,477,2004,07,39,2018,June,Sussex
696,577,419,1692,01,40,2018,June,Sussex
928,1444,740,3112,02,40,2018,June,Sussex
919,435,357,1711,03,40,2018,June,Sussex
715,1010,484,2209,04,40,2018,June,Sussex
549,548,350,1447,05,40,2018,June,Sussex
599,1014,506,2119,06,40,2018,June,Sussex
1054,1111,657,2822,07,40,2018,June,Sussex
426,450,294,1170,08,40,2018,June,Sussex
678,1151,505,2334,01,41,2018,June,Sussex
1014,1271,740,3025,02,41,2018,June,Sussex
744,554,349,1647,03,41,2018,June,Sussex
563,619,323,1505,04,41,2018,June,Sussex
1481,1153,731,3365,05,41,2018,June,Sussex
480,600,279,1359,06,41,2018,June,Sussex
710,665,390,1765,07,41,2018,June,Sussex
363,429,191,983,08,41,2018,June,Sussex
52,12,23,87,16,41,2018,June,Sussex
1585,1528,1105,4218,01,14,2018,July,Sussex
1246,1119,797,3162,02,14,2018,July,Sussex
1404,982,667,3053,03,14,2018,July,Sussex
1556,1243,883,3682,04,14,2018,July,Sussex
1326,1199,832,3357,05,14,2018,July,Sussex
867,700,458,2025,06,14,2018,July,Sussex
722,605,444,1771,07,14,2018,July,Sussex
850,511,434,1795,01,20,2018,July,Sussex
1165,1187,818,3170,02,20,2018,July,Sussex
1084,1300,816,3200,03,20,2018,July,Sussex
1300,1312,927,3539,04,20,2018,July,Sussex
1589,1525,1086,4200,05,20,2018,July,Sussex
713,817,603,2133,06,20,2018,July,Sussex
1097,914,683,2694,07,20,2018,July,Sussex
176,258,172,606,08,20,2018,July,Sussex
134,157,102,393,09,20,2018,July,Sussex
115,178,89,382,10,20,2018,July,Sussex
1142,1657,898,3697,01,35,2018,July,Sussex
1206,1290,761,3257,02,35,2018,July,Sussex
814,582,430,1826,03,35,2018,July,Sussex
1313,872,585,2770,04,35,2018,July,Sussex
250,318,173,741,05,35,2018,July,Sussex
335,482,228,1045,06,35,2018,July,Sussex
668,666,457,1791,07,35,2018,July,Sussex
925,835,708,2468,01,36,2018,July,Sussex
654,989,588,2231,02,36,2018,July,Sussex
906,988,714,2608,03,36,2018,July,Sussex
631,492,374,1497,04,36,2018,July,Sussex
389,572,310,1271,05,36,2018,July,Sussex
943,666,515,2124,06,36,2018,July,Sussex
806,571,426,1803,07,36,2018,July,Sussex
123,124,105,352,08,36,2018,July,Sussex
44,77,37,158,09,36,2018,July,Sussex
91,86,43,220,10,36,2018,July,Sussex
140,166,100,406,11,36,2018,July,Sussex
1089,678,537,2304,01,37,2018,July,Sussex
531,787,365,1683,02,37,2018,July,Sussex
1048,1331,814,3193,03,37,2018,July,Sussex
1308,1259,797,3364,04,37,2018,July,Sussex
1160,1026,733,2919,05,37,2018,July,Sussex
801,756,503,2060,06,37,2018,July,Sussex
598,842,426,1866,07,37,2018,July,Sussex
817,1352,664,2833,01,38,2018,July,Sussex
1118,1507,768,3393,02,38,2018,July,Sussex
1059,1447,763,3269,03,38,2018,July,Sussex
863,1161,610,2634,04,38,2018,July,Sussex
585,915,470,1970,05,38,2018,July,Sussex
958,1518,599,3075,06,38,2018,July,Sussex
1051,1564,833,3448,07,38,2018,July,Sussex
501,880,411,1792,08,38,2018,July,Sussex
647,1014,495,2156,01,39,2018,July,Sussex
1292,1001,653,2946,02,39,2018,July,Sussex
615,761,411,1787,03,39,2018,July,Sussex
1053,638,483,2174,04,39,2018,July,Sussex
498,792,397,1687,05,39,2018,July,Sussex
1035,1035,595,2665,06,39,2018,July,Sussex
795,732,477,2004,07,39,2018,July,Sussex
696,577,419,1692,01,40,2018,July,Sussex
928,1444,740,3112,02,40,2018,July,Sussex
919,435,357,1711,03,40,2018,July,Sussex
715,1010,484,2209,04,40,2018,July,Sussex
549,548,350,1447,05,40,2018,July,Sussex
599,1014,506,2119,06,40,2018,July,Sussex
1054,1111,657,2822,07,40,2018,July,Sussex
426,450,294,1170,08,40,2018,July,Sussex
678,1151,505,2334,01,41,2018,July,Sussex
1014,1271,740,3025,02,41,2018,July,Sussex
744,554,349,1647,03,41,2018,July,Sussex
563,619,323,1505,04,41,2018,July,Sussex
1481,1153,731,3365,05,41,2018,July,Sussex
480,600,279,1359,06,41,2018,July,Sussex
710,665,390,1765,07,41,2018,July,Sussex
363,429,191,983,08,41,2018,July,Sussex
52,12,23,87,16,41,2018,July,Sussex
1585,1528,1105,4218,01,14,2018,August,Sussex
1246,1119,797,3162,02,14,2018,August,Sussex
1404,982,667,3053,03,14,2018,August,Sussex
1556,1243,883,3682,04,14,2018,August,Sussex
1326,1199,832,3357,05,14,2018,August,Sussex
867,700,458,2025,06,14,2018,August,Sussex
722,605,444,1771,07,14,2018,August,Sussex
850,511,434,1795,01,20,2018,August,Sussex
1165,1187,818,3170,02,20,2018,August,Sussex
1084,1300,816,3200,03,20,2018,August,Sussex
1300,1312,927,3539,04,20,2018,August,Sussex
1589,1525,1086,4200,05,20,2018,August,Sussex
713,817,603,2133,06,20,2018,August,Sussex
1097,914,683,2694,07,20,2018,August,Sussex
176,258,172,606,08,20,2018,August,Sussex
134,157,102,393,09,20,2018,August,Sussex
115,178,89,382,10,20,2018,August,Sussex
1142,1657,898,3697,01,35,2018,August,Sussex
1206,1290,761,3257,02,35,2018,August,Sussex
814,582,430,1826,03,35,2018,August,Sussex
1313,872,585,2770,04,35,2018,August,Sussex
250,318,173,741,05,35,2018,August,Sussex
335,482,228,1045,06,35,2018,August,Sussex
668,666,457,1791,07,35,2018,August,Sussex
925,835,708,2468,01,36,2018,August,Sussex
654,989,588,2231,02,36,2018,August,Sussex
906,988,714,2608,03,36,2018,August,Sussex
631,492,374,1497,04,36,2018,August,Sussex
389,572,310,1271,05,36,2018,August,Sussex
943,666,515,2124,06,36,2018,August,Sussex
806,571,426,1803,07,36,2018,August,Sussex
123,124,105,352,08,36,2018,August,Sussex
44,77,37,158,09,36,2018,August,Sussex
91,86,43,220,10,36,2018,August,Sussex
140,166,100,406,11,36,2018,August,Sussex
1089,678,537,2304,01,37,2018,August,Sussex
531,787,365,1683,02,37,2018,August,Sussex
1048,1331,814,3193,03,37,2018,August,Sussex
1308,1259,797,3364,04,37,2018,August,Sussex
1160,1026,733,2919,05,37,2018,August,Sussex
801,756,503,2060,06,37,2018,August,Sussex
598,842,426,1866,07,37,2018,August,Sussex
817,1352,664,2833,01,38,2018,August,Sussex
1118,1507,768,3393,02,38,2018,August,Sussex
1059,1447,763,3269,03,38,2018,August,Sussex
863,1161,610,2634,04,38,2018,August,Sussex
585,915,470,1970,05,38,2018,August,Sussex
958,1518,599,3075,06,38,2018,August,Sussex
1051,1564,833,3448,07,38,2018,August,Sussex
501,880,411,1792,08,38,2018,August,Sussex
647,1014,495,2156,01,39,2018,August,Sussex
1292,1001,653,2946,02,39,2018,August,Sussex
615,761,411,1787,03,39,2018,August,Sussex
1053,638,483,2174,04,39,2018,August,Sussex
498,792,397,1687,05,39,2018,August,Sussex
1035,1035,595,2665,06,39,2018,August,Sussex
795,732,477,2004,07,39,2018,August,Sussex
696,577,419,1692,01,40,2018,August,Sussex
928,1444,740,3112,02,40,2018,August,Sussex
919,435,357,1711,03,40,2018,August,Sussex
715,1010,484,2209,04,40,2018,August,Sussex
549,548,350,1447,05,40,2018,August,Sussex
599,1014,506,2119,06,40,2018,August,Sussex
1054,1111,657,2822,07,40,2018,August,Sussex
426,450,294,1170,08,40,2018,August,Sussex
678,1151,505,2334,01,41,2018,August,Sussex
1014,1271,740,3025,02,41,2018,August,Sussex
744,554,349,1647,03,41,2018,August,Sussex
563,619,323,1505,04,41,2018,August,Sussex
1481,1153,731,3365,05,41,2018,August,Sussex
480,600,279,1359,06,41,2018,August,Sussex
710,665,390,1765,07,41,2018,August,Sussex
363,429,191,983,08,41,2018,August,Sussex
52,12,23,87,16,41,2018,August,Sussex
1585,1528,1105,4218,01,14,2018,September,Sussex
1246,1119,797,3162,02,14,2018,September,Sussex
1404,982,667,3053,03,14,2018,September,Sussex
1556,1243,883,3682,04,14,2018,September,Sussex
1326,1199,832,3357,05,14,2018,September,Sussex
867,700,458,2025,06,14,2018,September,Sussex
722,605,444,1771,07,14,2018,September,Sussex
850,511,434,1795,01,20,2018,September,Sussex
1165,1187,818,3170,02,20,2018,September,Sussex
1084,1300,816,3200,03,20,2018,September,Sussex
1300,1312,927,3539,04,20,2018,September,Sussex
1589,1525,1086,4200,05,20,2018,September,Sussex
713,817,603,2133,06,20,2018,September,Sussex
1097,914,683,2694,07,20,2018,September,Sussex
176,258,172,606,08,20,2018,September,Sussex
134,157,102,393,09,20,2018,September,Sussex
115,178,89,382,10,20,2018,September,Sussex
1142,1657,898,3697,01,35,2018,September,Sussex
1206,1290,761,3257,02,35,2018,September,Sussex
814,582,430,1826,03,35,2018,September,Sussex
1313,872,585,2770,04,35,2018,September,Sussex
250,318,173,741,05,35,2018,September,Sussex
335,482,228,1045,06,35,2018,September,Sussex
668,666,457,1791,07,35,2018,September,Sussex
925,835,708,2468,01,36,2018,September,Sussex
654,989,588,2231,02,36,2018,September,Sussex
906,988,714,2608,03,36,2018,September,Sussex
631,492,374,1497,04,36,2018,September,Sussex
389,572,310,1271,05,36,2018,September,Sussex
943,666,515,2124,06,36,2018,September,Sussex
806,571,426,1803,07,36,2018,September,Sussex
123,124,105,352,08,36,2018,September,Sussex
44,77,37,158,09,36,2018,September,Sussex
91,86,43,220,10,36,2018,September,Sussex
140,166,100,406,11,36,2018,September,Sussex
1089,678,537,2304,01,37,2018,September,Sussex
531,787,365,1683,02,37,2018,September,Sussex
1048,1331,814,3193,03,37,2018,September,Sussex
1308,1259,797,3364,04,37,2018,September,Sussex
1160,1026,733,2919,05,37,2018,September,Sussex
801,756,503,2060,06,37,2018,September,Sussex
598,842,426,1866,07,37,2018,September,Sussex
817,1352,664,2833,01,38,2018,September,Sussex
1118,1507,768,3393,02,38,2018,September,Sussex
1059,1447,763,3269,03,38,2018,September,Sussex
863,1161,610,2634,04,38,2018,September,Sussex
585,915,470,1970,05,38,2018,September,Sussex
958,1518,599,3075,06,38,2018,September,Sussex
1051,1564,833,3448,07,38,2018,September,Sussex
501,880,411,1792,08,38,2018,September,Sussex
647,1014,495,2156,01,39,2018,September,Sussex
1292,1001,653,2946,02,39,2018,September,Sussex
615,761,411,1787,03,39,2018,September,Sussex
1053,638,483,2174,04,39,2018,September,Sussex
498,792,397,1687,05,39,2018,September,Sussex
1035,1035,595,2665,06,39,2018,September,Sussex
795,732,477,2004,07,39,2018,September,Sussex
696,577,419,1692,01,40,2018,September,Sussex
928,1444,740,3112,02,40,2018,September,Sussex
919,435,357,1711,03,40,2018,September,Sussex
715,1010,484,2209,04,40,2018,September,Sussex
549,548,350,1447,05,40,2018,September,Sussex
599,1014,506,2119,06,40,2018,September,Sussex
1054,1111,657,2822,07,40,2018,September,Sussex
426,450,294,1170,08,40,2018,September,Sussex
678,1151,505,2334,01,41,2018,September,Sussex
1014,1271,740,3025,02,41,2018,September,Sussex
744,554,349,1647,03,41,2018,September,Sussex
563,619,323,1505,04,41,2018,September,Sussex
1481,1153,731,3365,05,41,2018,September,Sussex
480,600,279,1359,06,41,2018,September,Sussex
710,665,390,1765,07,41,2018,September,Sussex
363,429,191,983,08,41,2018,September,Sussex
52,12,23,87,16,41,2018,September,Sussex
1585,1528,1105,4218,01,14,2018,October,Sussex
1246,1119,797,3162,02,14,2018,October,Sussex
1404,982,667,3053,03,14,2018,October,Sussex
1556,1243,883,3682,04,14,2018,October,Sussex
1326,1199,832,3357,05,14,2018,October,Sussex
867,700,458,2025,06,14,2018,October,Sussex
722,605,444,1771,07,14,2018,October,Sussex
850,511,434,1795,01,20,2018,October,Sussex
1165,1187,818,3170,02,20,2018,October,Sussex
1084,1300,816,3200,03,20,2018,October,Sussex
1300,1312,927,3539,04,20,2018,October,Sussex
1589,1525,1086,4200,05,20,2018,October,Sussex
713,817,603,2133,06,20,2018,October,Sussex
1097,914,683,2694,07,20,2018,October,Sussex
176,258,172,606,08,20,2018,October,Sussex
134,157,102,393,09,20,2018,October,Sussex
115,178,89,382,10,20,2018,October,Sussex
1142,1657,898,3697,01,35,2018,October,Sussex
1206,1290,761,3257,02,35,2018,October,Sussex
814,582,430,1826,03,35,2018,October,Sussex
1313,872,585,2770,04,35,2018,October,Sussex
250,318,173,741,05,35,2018,October,Sussex
335,482,228,1045,06,35,2018,October,Sussex
668,666,457,1791,07,35,2018,October,Sussex
925,835,708,2468,01,36,2018,October,Sussex
654,989,588,2231,02,36,2018,October,Sussex
906,988,714,2608,03,36,2018,October,Sussex
631,492,374,1497,04,36,2018,October,Sussex
389,572,310,1271,05,36,2018,October,Sussex
943,666,515,2124,06,36,2018,October,Sussex
806,571,426,1803,07,36,2018,October,Sussex
123,124,105,352,08,36,2018,October,Sussex
44,77,37,158,09,36,2018,October,Sussex
91,86,43,220,10,36,2018,October,Sussex
140,166,100,406,11,36,2018,October,Sussex
1089,678,537,2304,01,37,2018,October,Sussex
531,787,365,1683,02,37,2018,October,Sussex
1048,1331,814,3193,03,37,2018,October,Sussex
1308,1259,797,3364,04,37,2018,October,Sussex
1160,1026,733,2919,05,37,2018,October,Sussex
801,756,503,2060,06,37,2018,October,Sussex
598,842,426,1866,07,37,2018,October,Sussex
817,1352,664,2833,01,38,2018,October,Sussex
1118,1507,768,3393,02,38,2018,October,Sussex
1059,1447,763,3269,03,38,2018,October,Sussex
863,1161,610,2634,04,38,2018,October,Sussex
585,915,470,1970,05,38,2018,October,Sussex
958,1518,599,3075,06,38,2018,October,Sussex
1051,1564,833,3448,07,38,2018,October,Sussex
501,880,411,1792,08,38,2018,October,Sussex
647,1014,495,2156,01,39,2018,October,Sussex
1292,1001,653,2946,02,39,2018,October,Sussex
615,761,411,1787,03,39,2018,October,Sussex
1053,638,483,2174,04,39,2018,October,Sussex
498,792,397,1687,05,39,2018,October,Sussex
1035,1035,595,2665,06,39,2018,October,Sussex
795,732,477,2004,07,39,2018,October,Sussex
696,577,419,1692,01,40,2018,October,Sussex
928,1444,740,3112,02,40,2018,October,Sussex
919,435,357,1711,03,40,2018,October,Sussex
715,1010,484,2209,04,40,2018,October,Sussex
549,548,350,1447,05,40,2018,October,Sussex
599,1014,506,2119,06,40,2018,October,Sussex
1054,1111,657,2822,07,40,2018,October,Sussex
426,450,294,1170,08,40,2018,October,Sussex
678,1151,505,2334,01,41,2018,October,Sussex
1014,1271,740,3025,02,41,2018,October,Sussex
744,554,349,1647,03,41,2018,October,Sussex
563,619,323,1505,04,41,2018,October,Sussex
1481,1153,731,3365,05,41,2018,October,Sussex
480,600,279,1359,06,41,2018,October,Sussex
710,665,390,1765,07,41,2018,October,Sussex
363,429,191,983,08,41,2018,October,Sussex
52,12,23,87,16,41,2018,October,Sussex
1585,1528,1105,4218,01,14,2018,November,Sussex
1246,1119,797,3162,02,14,2018,November,Sussex
1404,982,667,3053,03,14,2018,November,Sussex
1556,1243,883,3682,04,14,2018,November,Sussex
1326,1199,832,3357,05,14,2018,November,Sussex
867,700,458,2025,06,14,2018,November,Sussex
722,605,444,1771,07,14,2018,November,Sussex
850,511,434,1795,01,20,2018,November,Sussex
1165,1187,818,3170,02,20,2018,November,Sussex
1084,1300,816,3200,03,20,2018,November,Sussex
1300,1312,927,3539,04,20,2018,November,Sussex
1589,1525,1086,4200,05,20,2018,November,Sussex
713,817,603,2133,06,20,2018,November,Sussex
1097,914,683,2694,07,20,2018,November,Sussex
176,258,172,606,08,20,2018,November,Sussex
134,157,102,393,09,20,2018,November,Sussex
115,178,89,382,10,20,2018,November,Sussex
1142,1657,898,3697,01,35,2018,November,Sussex
1206,1290,761,3257,02,35,2018,November,Sussex
814,582,430,1826,03,35,2018,November,Sussex
1313,872,585,2770,04,35,2018,November,Sussex
250,318,173,741,05,35,2018,November,Sussex
335,482,228,1045,06,35,2018,November,Sussex
668,666,457,1791,07,35,2018,November,Sussex
925,835,708,2468,01,36,2018,November,Sussex
654,989,588,2231,02,36,2018,November,Sussex
906,988,714,2608,03,36,2018,November,Sussex
631,492,374,1497,04,36,2018,November,Sussex
389,572,310,1271,05,36,2018,November,Sussex
943,666,515,2124,06,36,2018,November,Sussex
806,571,426,1803,07,36,2018,November,Sussex
123,124,105,352,08,36,2018,November,Sussex
44,77,37,158,09,36,2018,November,Sussex
91,86,43,220,10,36,2018,November,Sussex
140,166,100,406,11,36,2018,November,Sussex
1089,678,537,2304,01,37,2018,November,Sussex
531,787,365,1683,02,37,2018,November,Sussex
1048,1331,814,3193,03,37,2018,November,Sussex
1308,1259,797,3364,04,37,2018,November,Sussex
1160,1026,733,2919,05,37,2018,November,Sussex
801,756,503,2060,06,37,2018,November,Sussex
598,842,426,1866,07,37,2018,November,Sussex
817,1352,664,2833,01,38,2018,November,Sussex
1118,1507,768,3393,02,38,2018,November,Sussex
1059,1447,763,3269,03,38,2018,November,Sussex
863,1161,610,2634,04,38,2018,November,Sussex
585,915,470,1970,05,38,2018,November,Sussex
958,1518,599,3075,06,38,2018,November,Sussex
1051,1564,833,3448,07,38,2018,November,Sussex
501,880,411,1792,08,38,2018,November,Sussex
647,1014,495,2156,01,39,2018,November,Sussex
1292,1001,653,2946,02,39,2018,November,Sussex
615,761,411,1787,03,39,2018,November,Sussex
1053,638,483,2174,04,39,2018,November,Sussex
498,792,397,1687,05,39,2018,November,Sussex
1035,1035,595,2665,06,39,2018,November,Sussex
795,732,477,2004,07,39,2018,November,Sussex
696,577,419,1692,01,40,2018,November,Sussex
928,1444,740,3112,02,40,2018,November,Sussex
919,435,357,1711,03,40,2018,November,Sussex
715,1010,484,2209,04,40,2018,November,Sussex
549,548,350,1447,05,40,2018,November,Sussex
599,1014,506,2119,06,40,2018,November,Sussex
1054,1111,657,2822,07,40,2018,November,Sussex
426,450,294,1170,08,40,2018,November,Sussex
678,1151,505,2334,01,41,2018,November,Sussex
1014,1271,740,3025,02,41,2018,November,Sussex
744,554,349,1647,03,41,2018,November,Sussex
563,619,323,1505,04,41,2018,November,Sussex
1481,1153,731,3365,05,41,2018,November,Sussex
480,600,279,1359,06,41,2018,November,Sussex
710,665,390,1765,07,41,2018,November,Sussex
363,429,191,983,08,41,2018,November,Sussex
52,12,23,87,16,41,2018,November,Sussex
